V,Si,So,TSi,TSo,Ni,No,TKNi,TKNo,M,DO,i,Sig/TS,Sig,Q,Th_c,Th,dS,dTS,dN,TKN,Thn,Th_cn
3132,261,44,309,19,49,11,87,22,2634,2.54,58,0.62,192,1746.83,9.69,9.17,217,290,38,65,2.2925,11.2174122
3105,220,37,271,22,44,11,88,23,2649,2.03,44,0.61,166,1561.05,10.5,9.21,183,249,33,65,2.3025,12.94889246
2916,207,33,235,21,42,10,79,20,2543,2.05,47,0.6,140,1481.19,13.41,9.16,174,214,32,59,2.29,16.77726066
2880,259,41,313,22,55,12,115,29,2450,2.44,58,0.65,204,1624.3,7.46,9.19,218,291,43,86,2.2975,9.768212126
2961,243,40,283,18,47,11,101,26,2466,2.39,54,0.6,169,1541.36,8.07,9.17,203,265,36,75,2.2925,9.624506016
2952,246,41,276,18,52,13,98,25,2484,2.03,47,0.62,170,1511.49,7.93,9.19,205,258,39,73,2.2975,10.33605361
3060,243,40,272,20,46,11,88,22,2650,2.26,52,0.64,174,1711.78,11.47,9.18,203,252,35,66,2.295,13.38838847
3006,249,40,300,16,50,12,95,24,2648,2.44,55,0.61,184,1726.81,11.13,9.15,209,284,38,71,2.2875,13.7809498
3015,241,39,295,18,49,12,100,26,2430,1.94,43,0.63,185,1597.47,8.24,9.19,202,277,37,74,2.2975,10.33045805
3042,266,42,298,25,49,12,97,25,2579,2.38,56,0.63,188,1669.78,8.37,9.18,224,273,37,72,2.295,9.507213146
3033,210,33,232,18,38,10,76,19,2646,2.03,45,0.65,151,1557.62,11.88,9.16,177,214,28,57,2.29,13.25543767
2952,224,36,249,21,43,10,94,24,2486,1.91,43,0.64,159,1480.64,11.2,9.19,188,228,33,70,2.2975,13.25719942
2916,268,45,331,25,54,13,94,23,2516,2.21,52,0.65,217,1628.41,7.48,9.15,223,306,41,71,2.2875,9.293384224
2898,245,40,271,20,52,12,102,26,2466,2.08,50,0.62,168,1517.46,9.05,9.17,205,251,40,76,2.2925,11.84402097
3033,230,37,278,23,54,13,113,28,2656,1.89,45,0.6,167,1665.05,10.11,9.14,193,255,41,85,2.285,14.63626987
2889,214,36,264,23,44,10,88,23,2474,1.9,44,0.65,171,1638.05,10.89,9.14,178,241,34,65,2.285,13.80638921
3096,226,37,265,16,47,12,93,24,2509,2.01,48,0.65,172,1568.03,9.19,9.14,189,249,35,69,2.285,11.78469262
3123,250,41,295,24,57,13,112,29,2696,2.21,51,0.62,182,1790.12,9.01,9.21,209,271,44,83,2.3025,12.66697657
2943,266,42,301,22,51,13,99,25,2508,2.32,55,0.6,182,1690.07,8.61,9.15,224,279,38,74,2.2875,10.17899779
2898,203,33,229,14,42,11,90,23,2555,1.77,41,0.59,136,1430.17,13.97,9.24,170,215,31,67,2.31,17.82226873
3087,230,38,278,22,43,11,81,20,2482,2.16,51,0.64,178,1624.31,12.07,9.17,192,256,32,61,2.2925,13.91429539
2934,238,39,274,23,45,11,95,25,2602,2.17,51,0.61,167,1627.99,12.35,9.21,199,251,34,70,2.3025,14.39845335
3105,260,43,312,20,48,11,92,23,2679,2.38,53,0.62,193,1548.34,10.68,9.14,217,292,37,69,2.285,12.15772936
2925,206,34,233,15,42,10,77,21,2557,1.71,37,0.64,148,1580.72,11.74,9.24,172,218,32,56,2.31,14.75922305
2934,229,38,259,17,48,11,101,25,2608,2.08,49,0.64,164,1494.16,9.22,9.24,191,242,37,76,2.31,11.91653534
3132,257,43,312,28,55,13,108,27,2575,2.17,50,0.64,200,1795.92,8.78,9.17,214,284,42,81,2.2925,11.5861037
2970,235,36,263,23,51,12,94,24,2486,1.93,46,0.62,164,1518.9,10.09,9.15,199,240,39,70,2.2875,13.50227066
2979,265,42,298,23,51,13,102,26,2563,2.35,52,0.61,182,1700.22,7.85,9.21,223,275,38,76,2.3025,9.315523981
2952,205,34,226,19,40,9,81,21,2681,1.66,39,0.62,139,1636.88,14.6,9.17,171,207,31,60,2.2925,17.56597722
3087,255,42,305,24,51,12,103,26,2617,2.39,53,0.63,192,1662.55,10.35,9.18,213,281,39,77,2.295,12.76390828
3114,254,43,313,22,57,13,116,31,2591,2.04,44,0.62,194,1679.53,7.86,9.12,211,291,44,85,2.28,10.87619572
3015,252,41,285,23,52,12,98,25,2486,2.24,51,0.64,181,1581.66,7.71,9.19,211,262,40,73,2.2975,9.810033946
3114,217,35,264,16,52,12,97,25,2681,2.09,48,0.62,165,1604.18,11.43,9.18,182,248,40,72,2.295,16.8889702
3015,234,38,277,16,48,11,98,26,2541,2.24,51,0.66,182,1552.11,10.7,9.18,196,261,37,72,2.295,13.53388516
2925,243,40,279,20,50,12,104,27,2575,2.23,54,0.65,182,1506.66,10.03,9.22,203,259,38,77,2.305,12.72559194
2916,258,43,288,24,49,13,100,26,2661,2.13,51,0.65,187,1605.93,10.01,9.24,215,264,36,74,2.31,11.72259554
3024,215,36,243,22,40,10,80,21,2488,1.79,42,0.6,146,1543.08,12.32,9.17,179,221,30,59,2.2925,14.13336479
3015,236,39,259,21,54,14,100,26,2431,1.95,44,0.6,156,1587.65,8.79,9.16,197,238,40,74,2.29,12.40177824
2952,240,39,280,23,47,11,96,25,2490,2.35,55,0.61,171,1578.74,9.33,9.2,201,257,36,71,2.3,11.26630721
3006,260,42,285,16,49,12,97,26,2510,2.12,49,0.61,175,1523.9,10.55,9.18,218,269,37,71,2.295,12.25994497
2961,251,39,297,25,51,11,87,23,2659,2.28,51,0.64,189,1479.26,8.99,9.17,212,272,40,64,2.2925,11.26339917
3114,203,33,231,20,42,11,85,22,2597,1.66,37,0.6,138,1618.44,9.94,9.19,170,211,31,63,2.2975,12.68098434
2952,247,40,289,21,55,13,98,25,2506,2.38,55,0.61,177,1612.26,11.43,9.14,207,268,42,73,2.285,15.69369817
3078,210,34,236,17,44,11,96,25,2486,1.81,43,0.59,140,1645.53,10.61,9.2,176,219,33,71,2.3,13.70762121
2916,256,43,313,24,52,13,93,25,2480,2.04,46,0.63,199,1545.94,8.57,9.19,213,289,39,68,2.2975,10.73389962
2988,252,40,313,18,51,13,100,26,2645,2.07,48,0.64,199,1664.33,8.89,9.22,212,295,38,74,2.305,11.09391223
2925,211,33,237,20,39,10,80,20,2421,1.69,37,0.62,147,1544.74,9.18,9.22,178,217,29,60,2.305,10.46256483
2889,246,41,271,25,47,12,86,22,2508,2.4,56,0.62,167,1537.38,8.22,9.15,205,246,35,64,2.2875,9.683846519
3105,202,32,223,20,39,10,86,22,2639,1.94,44,0.63,140,1719.07,12.98,9.19,170,203,29,64,2.2975,15.4525892
2916,235,38,284,22,53,12,106,28,2414,2.31,53,0.6,169,1477.33,8.62,9.19,197,262,41,78,2.2975,11.98749951
3051,257,42,290,19,52,12,102,26,2491,2.33,53,0.63,183,1672.59,10.88,9.19,215,271,40,76,2.2975,13.57414378
2880,232,38,273,19,53,13,97,26,2534,1.86,44,0.61,168,1650.1,9.74,9.13,194,254,40,71,2.2825,13.72019143
3006,243,40,298,25,52,12,102,26,2514,2.26,53,0.6,179,1673.13,11.64,9.18,203,273,40,76,2.295,15.35901553
3042,214,35,237,18,49,11,101,27,2461,1.8,39,0.66,155,1586.22,9.49,9.16,179,219,38,74,2.29,13.39867486
2970,221,37,260,23,45,10,78,19,2470,1.75,40,0.63,165,1591.02,9.1,9.14,184,237,35,59,2.285,11.42549334
3123,212,36,249,20,50,12,106,27,2477,1.72,38,0.65,161,1759.64,10.54,9.2,176,229,38,79,2.3,15.32809148
2970,268,44,333,22,51,13,89,23,2679,2.47,55,0.61,202,1480.01,9.38,9.15,224,311,38,66,2.2875,11.00655859
2979,200,32,233,18,39,9,71,18,2623,1.79,40,0.6,139,1552.7,12.23,9.21,168,215,30,53,2.3025,14.70531723
2970,252,40,308,26,53,12,110,28,2447,2.19,51,0.64,198,1610.27,9.7,9.16,212,282,41,82,2.29,12.57941348
3042,211,36,233,17,41,10,74,20,2584,1.82,43,0.65,151,1678.11,9.48,9.14,175,216,31,54,2.285,11.35855455
3141,217,37,238,21,44,11,88,22,2615,1.79,41,0.64,152,1643.05,11.73,9.22,180,217,33,66,2.305,14.66575022
3051,215,35,250,19,50,12,105,27,2412,1.78,42,0.63,158,1717.37,8.6,9.12,180,231,38,78,2.28,12.33227853
2943,248,39,297,23,55,13,110,29,2588,2.01,45,0.64,190,1631.8,10.3,9.18,209,274,42,81,2.295,14.0851528
3042,211,34,236,20,49,12,99,25,2460,2.07,47,0.61,144,1663.81,11.59,9.17,177,216,37,74,2.2925,16.59626611
3105,243,39,278,24,49,11,89,24,2586,2.21,52,0.63,175,1540.61,10.11,9.19,204,254,38,65,2.2975,12.57055033
2979,226,36,264,22,49,12,84,22,2671,2.08,47,0.6,159,1665.66,13,9.18,190,242,37,62,2.295,17.37978191
3114,237,38,278,25,50,12,105,27,2534,2.31,53,0.65,180,1702.09,9.77,9.13,199,253,38,78,2.2825,12.70953178
3042,237,38,265,21,54,13,107,27,2521,1.92,43,0.61,161,1666,8.53,9.16,199,244,41,80,2.29,11.98416485
3042,264,43,323,24,54,13,94,24,2695,2.4,55,0.61,197,1683.52,9.16,9.19,221,299,41,70,2.2975,11.55310275
2988,250,39,290,21,47,10,90,23,2443,2.2,50,0.65,187,1481.51,10.19,9.2,211,269,37,67,2.3,11.81259631
2952,250,41,280,23,47,12,89,23,2635,2.11,48,0.64,180,1513.39,9.4,9.13,209,257,35,66,2.2825,10.89680131
2979,265,42,321,19,53,12,106,27,2441,2.16,50,0.61,196,1628.19,9.03,9.22,223,302,41,79,2.305,11.13604751
3069,254,43,289,25,52,12,100,26,2688,2.12,47,0.66,189,1620.72,9.35,9.13,211,264,40,74,2.2825,11.8030587
3141,203,34,247,16,44,11,86,22,2475,1.92,46,0.63,155,1784.24,11.78,9.21,169,231,33,64,2.3025,15.74400642
3060,261,41,301,27,54,12,94,23,2476,2.5,56,0.63,191,1709.59,7.7,9.19,220,274,42,71,2.2975,9.823297726
2934,226,38,276,26,54,13,113,28,2628,1.91,42,0.62,172,1463.71,10.66,9.24,188,250,41,85,2.31,15.70564782
3024,214,34,258,19,42,10,80,21,2466,2.08,49,0.62,159,1564.71,10.31,9.14,180,239,32,59,2.285,12.47692348
2952,219,35,254,17,48,11,87,22,2462,1.87,44,0.61,156,1492.13,11.43,9.16,184,237,37,65,2.29,15.44744587
3051,235,37,276,21,47,12,83,22,2452,1.98,43,0.59,164,1676.79,11.45,9.17,198,255,35,61,2.2925,14.12045892
3033,256,42,285,18,52,12,104,27,2550,2.4,55,0.64,183,1707.16,9.13,9.12,214,267,40,77,2.28,11.43529796
3042,247,41,296,18,50,11,104,26,2412,2.28,52,0.6,179,1681.43,7.54,9.2,206,278,39,78,2.3,9.411475721
3141,230,39,278,20,48,11,88,22,2661,1.88,43,0.6,167,1698.42,11.75,9.19,191,258,37,66,2.2975,15.12044585
3069,254,42,316,20,56,13,110,29,2480,2.27,50,0.63,199,1720.57,9.78,9.2,212,296,43,81,2.3,13.29555572
3078,232,39,283,16,44,10,86,22,2694,2.06,49,0.65,185,1737.55,10.48,9.23,193,267,34,64,2.3075,12.25573335
2889,240,40,276,24,51,12,99,25,2440,2.02,48,0.6,165,1514.78,9.06,9.15,200,252,39,74,2.2875,11.87135962
2889,223,36,254,19,51,11,106,27,2483,2.04,48,0.61,155,1647.62,10.03,9.21,187,235,40,79,2.3025,14.14423865
3042,223,38,260,21,40,10,77,21,2483,1.84,40,0.63,163,1713.84,11.61,9.16,185,239,30,56,2.29,12.84105415
3087,245,40,270,20,44,11,86,22,2402,2.2,50,0.61,164,1644.45,9.62,9.19,205,250,33,64,2.2975,10.65307522
3060,246,40,289,19,54,12,99,26,2654,1.99,47,0.6,175,1623.8,9.82,9.18,206,270,42,73,2.295,13.29178996
2925,254,40,280,25,51,13,101,25,2695,2.39,56,0.66,184,1476.38,10.78,9.18,214,255,38,76,2.295,13.34653561
3033,214,36,259,19,47,11,90,22,2409,1.97,47,0.59,154,1681,9.26,9.14,178,240,36,68,2.285,12.5403137
2961,203,34,242,16,40,11,74,19,2616,1.71,38,0.6,145,1609.02,14.79,9.19,169,226,29,55,2.2975,17.96989157
3033,219,35,243,20,46,11,90,23,2500,2,48,0.6,145,1634.99,11.8,9.17,184,223,35,67,2.2925,15.28301549
3087,230,38,278,22,50,12,90,23,2463,2.19,51,0.59,165,1703.34,9.12,9.13,192,256,38,67,2.2825,12.22504133
2961,261,42,289,25,52,13,95,24,2589,2.34,55,0.64,184,1699.51,8.33,9.2,219,264,39,71,2.3,10.23342868
3024,202,35,246,22,48,11,92,25,2449,1.9,46,0.65,160,1707.75,11.41,9.14,167,224,37,67,2.285,16.71817402
3132,209,33,233,22,42,11,74,18,2622,2.05,44,0.63,148,1705.56,11.21,9.21,176,211,31,56,2.3025,13.89063009
2961,249,42,298,28,52,12,97,25,2602,2.08,45,0.64,190,1639.86,8.71,9.19,207,270,40,72,2.2975,11.21593492
3006,259,43,311,22,53,12,113,30,2480,2.49,57,0.62,194,1553.3,8.78,9.2,216,289,41,83,2.3,11.07857624
2907,238,41,292,20,46,11,92,24,2448,2.09,50,0.65,190,1558.79,9.19,9.13,197,272,35,68,2.2825,10.95241056
3015,249,41,273,23,48,12,90,23,2651,2.02,47,0.65,178,1605.51,8.75,9.15,208,250,36,67,2.2875,10.40071683
2961,245,40,293,19,54,13,107,28,2684,2.1,50,0.66,193,1656.66,9.01,9.22,205,274,41,79,2.305,12.24519754
3051,241,41,267,24,47,11,92,23,2408,2.26,49,0.6,160,1633.08,9.74,9.15,200,243,36,69,2.2875,11.71259433
2934,225,37,259,18,43,10,82,21,2464,2.01,47,0.63,162,1697.02,12.05,9.13,188,241,33,61,2.2825,14.1999336
3087,240,38,270,19,53,13,113,29,2436,2.18,51,0.64,174,1608.16,7.84,9.21,202,251,40,84,2.3025,10.67564245
3114,210,34,258,22,43,11,91,23,2443,1.77,40,0.61,156,1689.66,10.16,9.15,176,236,32,68,2.2875,12.82791868
2979,234,40,263,19,51,12,93,24,2642,1.86,45,0.65,171,1627.17,10.5,9.14,194,244,39,69,2.285,14.11097255
3114,267,44,310,22,54,13,102,27,2521,2.47,58,0.63,197,1762.69,8.9,9.2,223,288,41,75,2.3,11.09905068
2925,236,37,293,25,50,12,95,24,2588,2.06,47,0.64,187,1679.55,10.73,9.15,199,268,38,71,2.2875,14.01751575
2979,246,40,278,22,50,11,95,24,2558,2.39,53,0.62,173,1630.82,8.09,9.16,206,256,39,71,2.29,10.13903794
3105,215,35,265,21,49,11,95,24,2685,2,48,0.66,174,1546.9,13.63,9.2,180,244,38,71,2.3,19.15432294
3123,209,34,230,16,46,11,80,22,2664,2.01,46,0.62,143,1741.23,13.7,9.21,175,214,35,58,2.3025,18.59282758
2934,244,39,270,17,52,12,99,26,2401,2.02,47,0.65,175,1607.92,11.07,9.15,205,253,40,73,2.2875,14.54703445
3087,207,34,255,22,45,11,94,24,2507,1.98,47,0.64,164,1634.29,12.37,9.16,173,233,34,70,2.29,16.58155276
3078,257,41,284,23,54,12,108,28,2659,2.45,59,0.6,170,1621.44,10.62,9.16,216,261,42,80,2.29,13.75936788
3087,269,44,333,29,52,13,105,27,2690,2.39,56,0.62,205,1784.47,9.69,9.13,225,304,39,78,2.2825,11.55016451
2961,241,40,269,20,50,13,94,25,2642,2.09,45,0.6,162,1510.31,10.54,9.13,201,249,37,69,2.2825,13.48363234
3105,217,37,245,18,41,11,78,21,2515,1.89,42,0.62,151,1627.84,12.17,9.2,180,227,30,57,2.3,14.17842631
2952,269,46,300,20,51,12,93,24,2585,2.57,58,0.59,177,1673.39,8.44,9.19,223,280,39,69,2.2975,9.866739723
3024,247,41,297,20,52,13,110,28,2519,2.25,54,0.59,176,1637.54,10.09,9.22,206,277,39,82,2.305,13.09817793
3141,259,41,318,26,54,13,96,25,2672,2.47,59,0.6,192,1585.89,11.17,9.22,218,292,41,71,2.305,14.36020032
3132,209,36,237,18,48,11,87,22,2419,1.86,42,0.6,142,1644.1,10.39,9.14,173,219,37,65,2.285,14.71376543
2943,213,35,261,20,42,10,90,23,2453,1.95,43,0.64,167,1631.85,9.4,9.18,178,241,32,67,2.295,11.4290694
2970,211,35,262,17,48,11,98,26,2582,1.93,43,0.6,156,1698.3,11.11,9.23,176,245,37,72,2.3075,15.58425947
2988,264,43,328,27,55,14,98,24,2444,2.35,52,0.65,212,1592.21,7.44,9.23,221,301,41,74,2.3075,9.557515861
2907,269,42,329,24,53,13,94,24,2505,2.49,58,0.64,211,1681.11,7.68,9.13,227,305,40,70,2.2825,9.330354374
3069,225,37,257,18,42,10,81,21,2414,1.89,44,0.63,163,1622.54,8.68,9.21,188,239,32,60,2.3025,9.990789914
3132,243,39,270,22,52,12,93,25,2404,2.32,51,0.64,172,1783.94,8.94,9.14,204,248,40,68,2.285,11.79635729
2988,254,42,300,22,52,12,100,26,2412,2.03,47,0.63,188,1647.37,8.4,9.18,212,278,40,74,2.295,10.60381745
3105,269,43,304,25,57,14,109,28,2439,2.21,50,0.63,191,1706.8,7.34,9.21,226,279,43,81,2.3025,9.590294966
3114,212,35,241,15,42,10,81,20,2463,1.8,42,0.61,148,1758.36,9.56,9.22,177,226,32,61,2.305,11.67843508
3069,242,40,266,19,56,14,112,29,2451,2.15,48,0.63,167,1739.4,8.87,9.15,202,247,42,83,2.2875,12.65638304
2961,261,42,311,22,53,12,107,26,2576,2.19,51,0.59,184,1498.75,8.07,9.2,219,289,41,81,2.3,10.10467213
2943,221,37,270,22,51,12,100,25,2660,1.87,43,0.63,169,1694.42,13.51,9.13,184,248,39,75,2.2825,19.22412496
2916,263,44,295,19,51,12,97,25,2492,2.11,50,0.63,185,1446.92,7.43,9.19,219,276,39,72,2.2975,8.884164075
3096,253,41,301,22,56,13,117,29,2548,2.17,48,0.6,180,1714.28,7.78,9.14,212,279,43,88,2.285,10.61843302
2907,251,41,311,27,47,11,80,21,2524,2.43,55,0.64,199,1478.42,9.07,9.2,210,284,36,59,2.3,10.47236457
3042,200,33,229,17,43,10,81,21,2657,1.95,45,0.64,146,1753.59,15.08,9.16,167,212,33,60,2.29,19.99185673
2880,268,45,313,26,53,12,96,25,2501,2.23,52,0.64,201,1470.13,8.6,9.17,223,287,41,71,2.2925,10.48703835
2952,249,40,273,22,52,13,98,25,2411,2.18,49,0.63,173,1685.51,9.37,9.16,209,251,39,73,2.29,12.06582207
2952,220,36,241,20,42,10,93,25,2549,2.06,47,0.61,147,1538.56,12.41,9.16,184,221,32,68,2.29,14.60870504
3096,214,36,234,18,42,10,85,22,2682,1.71,41,0.62,146,1665.65,10.69,9.14,178,216,32,63,2.285,12.93679069
2880,259,43,291,20,47,11,89,22,2623,2.12,50,0.66,191,1638.27,7.95,9.15,216,271,36,67,2.2875,8.895667709
3069,226,37,256,21,45,11,83,21,2452,2.16,48,0.64,163,1694.89,8.88,9.17,189,235,34,62,2.2925,10.9026073
3141,217,35,250,21,46,10,94,24,2506,1.76,42,0.64,161,1733.53,11.7,9.13,182,229,36,70,2.2825,15.29316199
3087,209,34,241,14,42,11,82,21,2699,2.05,45,0.59,143,1608.11,14.29,9.21,175,227,31,61,2.3025,17.70714576
2979,240,40,265,20,44,11,88,23,2485,2.04,48,0.66,174,1676.94,11.91,9.21,200,245,33,65,2.3025,13.46376509
2907,228,38,263,17,48,12,90,23,2410,2.06,50,0.65,172,1505.41,10.34,9.13,190,246,36,67,2.2825,13.42271158
3087,237,39,285,18,44,11,92,23,2606,2.16,48,0.61,173,1676.96,9.59,9.14,198,267,33,69,2.285,10.97832964
3060,242,41,273,20,49,12,89,23,2622,2.17,50,0.62,171,1750.93,9.63,9.23,201,253,37,66,2.3075,12.02320717
3024,210,33,255,18,46,11,87,23,2404,2.02,46,0.6,153,1604.07,11.74,9.23,177,237,35,64,2.3075,15.85696119
2943,218,37,245,16,50,11,103,27,2567,1.84,41,0.6,146,1558.96,10.32,9.15,181,229,39,76,2.2875,14.59508193
2988,220,36,253,19,42,10,80,20,2683,2.1,48,0.61,156,1514.61,9.73,9.18,184,234,32,60,2.295,11.45388396
3105,260,41,322,23,53,13,102,27,2515,2.23,52,0.63,204,1576.98,8.99,9.17,219,299,40,75,2.2925,11.29992452
3114,258,44,315,27,52,13,100,25,2497,2.29,52,0.66,208,1761.49,9.15,9.12,214,288,39,75,2.28,11.37150799
2898,232,38,271,16,51,12,94,25,2572,2.05,47,0.63,172,1629.13,9.79,9.18,194,255,39,69,2.295,13.27022273
3114,243,39,301,29,51,13,91,24,2556,2.3,53,0.62,187,1767,11.09,9.18,204,272,38,67,2.295,14.35187945
2952,209,33,248,18,42,10,81,21,2400,1.98,46,0.6,148,1596.81,9.71,9.14,176,230,32,60,2.285,12.03193739
3132,210,34,246,19,45,11,83,22,2688,1.83,44,0.63,154,1640.16,14.22,9.17,176,227,34,61,2.2925,18.78910722
2898,252,42,282,18,51,11,100,25,2697,2.24,52,0.59,167,1524.66,12.02,9.21,210,264,40,75,2.3025,14.99986783
3024,205,32,236,16,45,11,84,22,2672,2.01,45,0.64,152,1739.53,10.07,9.14,173,220,34,62,2.285,13.63017565
3114,269,43,296,23,55,14,103,28,2661,2.51,61,0.6,179,1697.6,8.8,9.2,226,273,41,75,2.3,11.09446619
3069,222,37,249,21,43,11,93,23,2614,2.07,49,0.63,156,1682.78,9.6,9.19,185,228,32,70,2.2975,11.46568599
2916,202,33,233,19,46,12,94,24,2471,1.71,38,0.63,148,1655.88,11.22,9.21,169,214,34,70,2.3025,15.75479108
2907,225,38,266,18,52,13,100,26,2558,1.8,40,0.64,170,1531.97,11.69,9.15,187,248,39,74,2.2875,16.65898994
2988,237,38,284,21,51,13,102,27,2405,2.18,51,0.59,168,1514.58,9.2,9.18,199,263,38,75,2.295,12.2073947
3069,246,40,279,22,46,10,84,22,2570,2.09,49,0.59,165,1696.67,10.81,9.2,206,257,36,62,2.3,12.46412362
3051,250,40,301,24,46,11,91,23,2616,2.15,48,0.59,178,1618.96,10.16,9.18,210,277,35,68,2.295,11.52722739
2943,240,39,275,20,51,12,95,25,2589,2.05,47,0.65,178,1568.14,11.53,9.19,201,255,39,70,2.2975,15.10781197
2961,251,39,274,25,52,12,105,28,2566,2.08,48,0.65,178,1650.45,8.31,9.13,212,249,40,77,2.2825,10.61558605
2952,245,38,287,27,54,12,98,25,2583,2.12,48,0.64,184,1684.17,9.96,9.13,207,260,42,73,2.2825,13.5363116
3132,218,35,259,20,43,11,82,21,2566,1.91,46,0.64,166,1586.98,12.17,9.19,183,239,32,61,2.2975,14.80184559
3114,242,41,290,21,47,12,94,24,2440,2.16,51,0.63,184,1742.03,10.53,9.22,201,269,35,70,2.305,12.6102644
3141,244,41,271,19,55,13,114,29,2456,1.99,48,0.64,172,1684.02,9.98,9.18,203,252,42,85,2.295,13.87128624
2880,238,40,284,25,48,11,91,23,2445,2.24,53,0.65,185,1554.51,8.48,9.2,198,259,37,68,2.3,10.54565263
2898,233,40,271,16,46,12,90,22,2494,2.26,52,0.61,166,1614.08,8.6,9.18,193,255,34,68,2.295,10.46920469
3033,208,34,235,17,41,10,81,20,2471,1.8,43,0.62,146,1498.46,9.52,9.23,174,218,31,61,2.3075,11.57099749
3114,242,41,279,22,53,12,99,26,2594,1.96,47,0.59,165,1726.29,11.08,9.18,201,257,41,73,2.295,14.96282489
2934,264,41,296,25,52,12,96,25,2667,2.4,56,0.61,180,1452.25,8.24,9.21,223,271,40,71,2.3025,10.00783088
2988,268,44,303,26,52,13,106,28,2406,2.26,51,0.64,194,1671.54,8.54,9.14,224,277,39,78,2.285,10.21738479
3123,225,36,262,18,47,12,85,21,2663,2.1,50,0.6,158,1596.38,11.96,9.15,189,244,35,64,2.2875,15.40493424
3132,247,40,276,16,51,13,99,26,2534,2.28,53,0.61,169,1638.25,10.3,9.22,207,260,38,73,2.305,13.11365569
3015,217,36,260,20,44,11,86,22,2467,1.91,43,0.59,154,1655.11,8.85,9.14,181,240,33,64,2.285,11.06495221
2952,259,43,289,24,59,14,126,32,2409,2.42,58,0.61,175,1663.48,8.37,9.2,216,265,45,94,2.3,11.75685156
2943,228,37,265,19,50,11,108,28,2648,2,45,0.65,173,1668.23,11.69,9.19,191,246,39,80,2.2975,15.80749299
3096,240,39,271,23,53,13,98,25,2480,2.07,50,0.6,162,1703.72,10.56,9.2,201,248,40,73,2.3,14.37943677
2898,255,42,285,23,56,14,98,25,2579,2.05,46,0.65,186,1535.64,9.74,9.24,213,262,42,73,2.31,13.18925098
2952,208,33,232,21,41,11,77,19,2580,1.97,45,0.64,148,1507.61,11.78,9.16,175,211,30,58,2.29,14.31789395
3042,242,40,295,25,46,10,90,23,2639,2.02,48,0.6,177,1516.7,8.47,9.19,202,270,36,67,2.2975,9.927484217
2934,235,38,276,21,46,11,93,24,2450,2.28,50,0.63,175,1550.09,9.89,9.18,197,255,35,69,2.295,11.93712084
2880,267,43,313,23,56,13,107,28,2577,2.4,55,0.64,200,1538.03,7.65,9.17,224,290,43,79,2.2925,9.89353581
2925,268,45,321,21,54,13,99,26,2412,2.39,55,0.63,202,1570.1,9.1,9.16,223,300,41,73,2.29,11.30612252
3006,249,39,276,23,48,12,103,27,2517,2.45,58,0.63,172,1578.61,8.61,9.23,210,253,36,76,2.3075,10.23430536
2934,243,41,294,28,54,13,101,26,2657,2.2,53,0.62,182,1556.05,9.34,9.14,202,266,41,75,2.285,12.79816461
3114,255,42,284,21,50,13,93,24,2519,2.47,56,0.65,186,1693.74,9.83,9.18,213,263,37,69,2.295,11.88493117
2997,257,41,312,25,53,13,98,25,2534,2.52,56,0.63,196,1521.26,7.69,9.22,216,287,40,73,2.305,9.778729107
3015,251,42,291,23,52,12,105,27,2638,2.1,49,0.6,175,1552.16,8.8,9.18,209,268,40,78,2.295,11.24153517
3114,205,35,246,19,43,11,85,21,2548,1.65,38,0.62,152,1588.14,12.8,9.22,170,227,32,64,2.305,16.55533196
2961,201,33,226,17,41,9,75,19,2574,1.94,45,0.66,148,1539.51,10.5,9.14,168,209,32,56,2.285,13.20658186
3114,223,36,250,15,43,10,79,20,2545,2.15,49,0.62,156,1616.47,12.43,9.2,187,235,33,59,2.3,14.77910213
2934,246,41,305,23,48,12,89,22,2430,2.32,51,0.59,181,1644.19,9.33,9.16,205,282,36,67,2.29,11.22538134
2961,208,35,234,18,40,9,78,20,2689,1.92,43,0.65,153,1548.79,13.99,9.22,173,216,31,58,2.305,16.58928622
2925,256,40,290,19,54,13,108,27,2436,2.43,58,0.6,175,1548.71,8.91,9.2,216,271,41,81,2.3,11.58896971
2907,248,39,278,22,50,12,96,25,2506,2.2,51,0.59,165,1643.06,9.51,9.21,209,256,38,71,2.3025,11.8225775
2988,214,36,241,21,49,12,93,24,2675,1.84,43,0.63,153,1677.12,13.72,9.15,178,220,37,69,2.2875,19.37089769
3060,237,40,280,21,56,13,113,28,2597,2.15,49,0.63,176,1726.18,9.37,9.15,197,259,43,85,2.2875,13.65188437
2961,260,42,321,27,59,15,115,30,2672,2.26,53,0.6,193,1639.81,11.17,9.19,218,294,44,85,2.2975,15.62950292
3069,224,38,253,19,44,11,80,20,2698,1.78,39,0.63,159,1638.52,12.05,9.21,186,234,33,60,2.3025,14.59503142
3105,202,32,247,20,36,9,66,17,2538,1.71,39,0.62,154,1760.23,9.9,9.14,170,227,27,49,2.285,10.8792675
3123,252,41,277,22,50,12,96,24,2465,2.28,53,0.66,181,1657.79,9.66,9.22,211,255,38,72,2.305,11.81843359
3123,226,39,261,17,48,11,96,24,2628,1.92,46,0.6,157,1680.34,10.71,9.19,187,244,37,72,2.2975,14.02605696
3141,210,34,240,22,38,9,78,20,2589,1.68,40,0.6,144,1614.32,13.24,9.2,176,218,29,58,2.3,14.77289518
3087,245,41,283,22,49,12,87,22,2669,2.34,53,0.6,169,1620.23,11.12,9.19,204,261,37,65,2.2975,13.71349373
2925,215,33,245,19,45,11,88,23,2519,1.81,40,0.59,144,1544.68,9.52,9.22,182,226,34,65,2.305,12.28639098
3006,209,35,258,21,44,11,78,20,2644,1.82,42,0.65,169,1590.51,13.64,9.21,174,237,33,58,2.3025,17.7065557
2970,212,34,246,22,42,10,78,20,2449,1.86,45,0.61,151,1692.78,9.2,9.22,178,224,32,58,2.305,11.23866138
2898,216,36,249,20,45,11,86,22,2673,1.92,45,0.63,157,1445.23,13.67,9.24,180,229,34,64,2.31,17.56065078
2889,203,33,233,17,45,11,91,24,2693,1.97,45,0.6,140,1493.91,13.01,9.14,170,216,34,67,2.285,17.78308489
3069,203,34,235,15,48,11,83,22,2553,1.91,45,0.64,150,1632.67,13.94,9.16,169,220,37,61,2.29,20.32456702
2907,228,38,269,20,47,11,94,25,2539,1.94,43,0.6,161,1635.28,10.51,9.13,190,249,36,69,2.2825,13.35915707
3078,215,34,258,20,46,11,97,25,2535,1.81,40,0.65,168,1547.24,11.06,9.21,181,238,35,72,2.3025,14.59109308
2952,205,33,237,16,46,11,83,22,2528,1.71,41,0.61,145,1526.61,12.15,9.23,172,221,35,61,2.3075,16.81100115
3060,223,36,258,17,45,10,88,22,2694,2.1,50,0.62,161,1615.6,11.81,9.23,187,241,35,66,2.3075,14.69504355
3033,250,40,283,20,44,11,83,21,2561,2.05,48,0.66,186,1541.87,8.01,9.2,210,263,33,62,2.3,8.692776491
3123,225,36,265,22,52,13,105,27,2570,1.83,40,0.6,160,1571.82,8.81,9.15,189,243,39,78,2.2875,12.55480765
2943,221,36,259,23,47,11,88,22,2595,2.03,46,0.64,167,1660.53,10.06,9.19,185,236,36,66,2.2975,13.1921899
3015,201,34,248,17,47,11,98,25,2472,1.78,38,0.59,147,1534.32,12.27,9.15,167,231,36,73,2.2875,17.69129778
2943,242,40,290,22,54,12,101,26,2504,2.19,50,0.62,181,1499.13,11.21,9.14,202,268,42,75,2.285,15.42401133
2889,209,35,233,19,40,10,74,19,2578,1.86,41,0.61,142,1507.1,13.81,9.15,174,214,30,55,2.2875,16.29748962
2925,201,34,224,22,48,12,88,23,2496,1.87,43,0.62,139,1565.53,11.62,9.24,167,202,36,65,2.31,17.1105763
3051,250,40,297,20,51,12,95,25,2668,2.12,50,0.61,182,1654.89,10.34,9.16,210,277,39,70,2.29,13.00660752
2979,246,40,302,23,52,11,104,26,2517,2.37,53,0.64,192,1698.86,8.28,9.17,206,279,41,78,2.2925,10.79224765
3132,240,38,290,23,54,12,94,24,2410,1.99,47,0.65,188,1740.73,9.68,9.15,202,267,42,70,2.2875,13.42985132
3015,202,33,238,19,39,9,81,20,2686,1.76,43,0.66,157,1724.64,11.91,9.23,169,219,30,61,2.3075,14.17876251
2943,200,33,224,20,40,10,75,21,2599,1.7,41,0.65,146,1498.8,12.77,9.24,167,204,30,54,2.31,15.74831968
3087,240,40,285,21,54,12,105,27,2408,2.17,51,0.64,183,1755.71,11.15,9.16,200,264,42,78,2.29,15.46930188
3033,254,40,304,23,49,11,98,24,2653,2.2,50,0.64,195,1513.8,11.41,9.14,214,281,38,74,2.285,13.57254646
2925,216,37,243,20,38,9,85,21,2534,1.99,46,0.64,155,1503.21,10.13,9.15,179,223,29,64,2.2875,10.98885949
3024,245,41,278,23,54,12,101,26,2692,2.37,55,0.63,174,1552.89,9.31,9.16,204,255,42,75,2.29,12.65291777
2925,227,37,255,17,47,11,91,24,2650,2.17,50,0.64,164,1535.14,10.46,9.24,190,238,36,67,2.31,13.35417351
3078,232,40,282,20,51,12,106,27,2585,1.94,46,0.6,170,1534.98,11.59,9.19,192,262,39,79,2.2975,15.71010025
2997,257,43,290,20,54,13,102,26,2441,2.48,57,0.6,175,1536.93,7.36,9.17,214,270,41,76,2.2925,9.53568245
3015,264,42,294,24,47,11,85,21,2630,2.48,60,0.63,185,1642.51,9.09,9.21,222,270,36,64,2.3025,9.978635145
3096,222,36,265,17,43,11,86,22,2443,1.84,44,0.65,172,1679.79,10.06,9.16,186,248,32,64,2.29,12.01508344
3123,255,42,299,24,45,11,82,21,2611,2.42,56,0.63,188,1711.08,8.17,9.15,213,275,34,61,2.2875,8.890121964
2997,242,39,278,18,53,13,91,24,2428,2.09,48,0.59,165,1488.09,11.36,9.23,203,260,40,67,2.3075,15.34094681
3123,208,35,241,17,49,11,88,22,2696,1.73,39,0.65,157,1600.35,12.69,9.13,173,224,38,66,2.2825,18.43349546
3078,254,41,288,16,50,13,87,23,2416,2.4,53,0.63,181,1553.05,8.57,9.18,213,272,37,64,2.295,10.40232549
3024,222,36,257,17,43,11,83,21,2413,2.16,49,0.6,153,1572.6,10.42,9.23,186,240,32,62,2.3075,12.44504666
2925,239,39,295,24,51,12,96,24,2648,2.3,54,0.6,177,1622.95,10.35,9.21,200,271,39,72,2.3025,13.61839586
2916,234,39,265,18,47,11,85,22,2524,2.1,47,0.61,160,1679.73,9.59,9.16,195,247,36,63,2.29,11.87719637
2970,262,44,287,20,49,11,95,25,2516,2.32,54,0.64,184,1688.03,7.48,9.16,218,267,38,70,2.29,8.626005204
3114,236,39,262,21,51,13,88,23,2485,2.14,50,0.62,164,1579.29,9.55,9.13,197,241,38,65,2.2825,12.72550055
3141,203,34,241,18,45,10,86,23,2524,1.62,38,0.65,157,1702.52,12.62,9.12,169,223,35,63,2.28,17.25000241
3033,211,35,242,20,47,12,90,22,2677,1.77,42,0.65,156,1683.24,10.65,9.12,176,222,35,68,2.28,14.6277773
2925,247,42,300,20,47,11,86,22,2487,2.04,48,0.59,178,1548.81,8.41,9.2,205,280,36,64,2.3,9.867570313
3132,203,32,225,16,36,9,71,19,2546,1.77,41,0.6,136,1666.83,10.72,9.15,171,209,27,52,2.2875,11.72234712
3042,203,33,243,17,45,10,84,22,2621,1.84,40,0.6,146,1574.27,12.45,9.18,170,226,35,62,2.295,17.01763312
2889,264,43,301,19,59,14,109,28,2517,2.58,61,0.66,199,1659.59,8.15,9.19,221,282,45,81,2.2975,11.2310154
3006,213,35,239,17,44,10,83,21,2476,2.04,48,0.6,143,1701.01,10.33,9.16,178,222,34,62,2.29,13.15790431
2988,256,41,304,21,55,13,106,26,2405,2.22,48,0.64,196,1577.01,7.69,9.18,215,283,42,80,2.295,10.18737735
2997,243,40,279,26,50,12,102,26,2551,2.09,46,0.62,174,1592,9.53,9.13,203,253,38,76,2.2825,12.09121547
2880,213,35,248,17,45,11,95,24,2457,1.85,44,0.64,159,1631.82,10.29,9.19,178,231,34,71,2.2975,13.40483937
2880,245,42,299,18,50,11,87,22,2630,2.15,50,0.63,190,1505.39,8.66,9.23,203,281,39,65,2.3075,10.89770735
3033,228,38,270,25,47,12,96,25,2542,2.12,50,0.64,174,1723.09,11.84,9.12,190,245,35,71,2.28,15.04970692
3114,200,32,248,24,42,11,78,19,2646,1.64,36,0.65,161,1734.72,10.14,9.13,168,224,31,59,2.2825,13.13017695
2952,266,43,302,28,52,12,100,26,2415,2.57,56,0.61,184,1636.16,7.88,9.22,223,274,40,74,2.305,9.498636186
2907,257,41,295,22,53,12,98,25,2700,2.09,47,0.65,191,1499.19,8.66,9.21,216,273,41,73,2.3025,11.01219689
3078,263,42,320,25,53,12,113,29,2532,2.3,52,0.65,206,1730.13,8.15,9.18,221,295,41,84,2.295,10.127239
2916,251,41,310,20,52,12,96,25,2678,2.46,59,0.66,203,1595.1,8.88,9.21,210,290,40,71,2.3025,11.34373094
2952,241,40,267,21,53,13,99,26,2588,2.03,46,0.66,176,1542.21,9.61,9.19,201,246,40,73,2.2975,13.03153407
3114,203,34,248,19,44,11,89,23,2582,1.91,45,0.59,147,1671.28,14.22,9.17,169,229,33,66,2.2925,19.00507397
2961,235,39,265,19,49,12,92,23,2524,2.24,52,0.65,173,1686.38,10.47,9.19,196,246,37,69,2.2975,13.46133799
3078,254,43,281,20,47,11,101,25,2622,2.38,55,0.65,183,1711.81,8.32,9.19,211,261,36,76,2.2975,9.492941332
3024,234,40,283,22,51,12,92,24,2524,1.99,46,0.6,169,1537.26,11.65,9.21,194,261,39,68,2.3025,15.65646002
3132,224,37,274,23,45,11,94,24,2418,1.82,41,0.64,176,1658.63,8.31,9.15,187,251,34,70,2.2875,10.29387401
3006,227,37,267,21,41,9,78,20,2606,1.96,44,0.64,172,1649.53,11.23,9.18,190,246,32,58,2.295,12.50694054
2934,230,37,263,17,50,12,99,25,2448,1.98,46,0.61,160,1555.24,10.42,9.24,193,246,38,74,2.31,13.9676459
3033,227,37,254,18,48,12,92,24,2603,2.03,48,0.61,155,1680.56,8.93,9.18,190,236,36,68,2.295,11.6434094
3042,213,34,251,18,48,12,93,24,2551,1.72,41,0.65,163,1659.68,11.85,9.19,179,233,36,69,2.2975,16.46619725
2943,238,37,269,23,45,10,79,21,2475,2.02,46,0.66,177,1520.3,10.6,9.15,201,246,35,58,2.2875,12.35818668
2988,238,39,272,25,48,11,95,24,2423,1.98,47,0.66,179,1661.45,8.35,9.15,199,247,37,71,2.2875,10.38398579
3024,202,33,221,19,42,11,74,20,2476,1.84,40,0.6,133,1745.28,12.5,9.15,169,202,31,54,2.2875,16.025857
2979,268,43,329,24,47,11,88,23,2607,2.55,56,0.62,205,1660.62,8.58,9.13,225,305,36,65,2.2825,9.278198956
2934,216,35,247,17,42,10,80,21,2695,1.92,45,0.6,147,1612.13,10.84,9.13,181,230,32,59,2.2825,12.99685132
3078,253,41,286,18,54,14,106,28,2576,2.05,47,0.65,187,1680.06,10.47,9.15,212,268,40,78,2.2875,13.77949335
3132,211,36,239,17,43,10,82,21,2580,1.7,38,0.64,154,1705.9,12.71,9.12,175,222,33,61,2.28,15.97146963
3123,206,34,228,18,40,10,79,21,2632,1.85,41,0.63,143,1801.06,11.19,9.15,172,210,30,58,2.2875,13.39788318
3123,229,37,279,21,52,13,105,27,2605,1.95,43,0.62,173,1649.69,11.41,9.22,192,258,39,78,2.305,15.97595524
2961,263,43,318,20,49,12,92,25,2502,2.13,48,0.6,189,1572.22,7.69,9.17,220,298,37,67,2.2925,8.834459835
3105,269,44,302,20,51,13,102,26,2644,2.36,55,0.65,195,1617.66,7.86,9.17,225,282,38,76,2.2925,9.188693628
2889,233,39,278,23,48,12,102,27,2608,2.16,49,0.62,173,1592.95,10.75,9.23,194,255,36,75,2.3075,13.65548438
2907,259,40,319,26,55,13,118,31,2431,2.52,56,0.63,201,1569.33,9.48,9.2,219,293,42,87,2.3,12.41322399
2988,208,34,248,18,47,11,96,24,2495,1.86,42,0.6,149,1618.66,12.57,9.13,174,230,36,72,2.2825,17.51391066
3069,245,39,301,22,55,14,104,27,2499,2.27,51,0.61,183,1727.02,7.75,9.17,206,279,41,77,2.2925,10.72782393
3096,269,43,334,28,56,14,113,29,2456,2.38,57,0.65,216,1663.61,8.46,9.16,226,306,42,84,2.29,10.85974029
3006,247,40,305,22,50,13,106,26,2556,2.09,48,0.65,198,1573.04,9.84,9.17,207,283,37,80,2.2925,12.28235028
3096,223,36,276,24,49,12,98,25,2664,2.2,50,0.59,163,1755.9,10.69,9.22,187,252,37,73,2.305,14.48379107
2898,266,44,315,25,53,12,93,23,2698,2.22,52,0.64,200,1467.91,11.6,9.24,222,290,41,70,2.31,14.25166323
3087,235,37,262,21,43,11,87,22,2425,2.32,53,0.6,157,1654.62,9.96,9.13,198,241,32,65,2.2825,11.23759202
2889,227,37,266,20,45,11,80,21,2623,1.82,43,0.62,166,1607.67,11.76,9.14,190,246,34,59,2.285,14.37498194
3105,222,35,251,19,52,13,100,25,2644,1.86,43,0.61,153,1797.21,9.62,9.12,187,232,39,75,2.28,13.89436714
3060,205,35,247,22,39,10,83,21,2545,1.98,45,0.6,149,1682.22,10.15,9.12,170,225,29,62,2.28,11.90666453
2988,233,38,284,23,49,11,93,24,2565,1.89,44,0.64,182,1500.67,12.01,9.13,195,261,38,69,2.2825,15.57386822
2916,227,38,271,18,49,12,87,22,2570,1.92,44,0.59,160,1521.4,8.98,9.15,189,253,37,65,2.2875,11.95253128
3060,212,34,259,21,49,12,91,25,2438,1.89,45,0.6,155,1707.56,9.59,9.2,178,238,37,66,2.3,13.66759671
3015,244,39,277,22,51,12,97,25,2604,1.99,45,0.62,170,1493.16,8.66,9.21,205,255,39,72,2.3025,11.16121749
3015,201,34,232,20,40,10,70,19,2688,1.93,45,0.6,138,1498.87,14.82,9.17,167,212,30,51,2.2925,18.18550924
3006,253,40,311,22,49,11,97,25,2626,2.13,50,0.66,205,1712.37,10.75,9.18,213,289,38,72,2.295,12.83799944
3105,228,38,269,24,47,11,100,26,2478,2.09,47,0.62,167,1723.56,9.63,9.12,190,245,36,74,2.28,12.24059778
3051,204,34,223,17,46,11,90,24,2684,1.91,44,0.64,141,1626.88,12.52,9.18,170,206,35,66,2.295,17.40785748
3114,241,39,272,19,51,13,91,24,2574,2.32,53,0.62,167,1773.03,11.61,9.19,202,253,38,67,2.2975,15.14951336
3015,250,39,309,23,46,11,91,23,2661,2.02,47,0.62,190,1562.01,8.14,9.12,211,286,35,68,2.28,9.235396746
3069,221,36,247,21,44,10,81,21,2639,2.01,47,0.6,149,1759.9,13.09,9.12,185,226,34,60,2.28,16.06990756
3051,216,35,253,17,48,12,92,24,2655,1.73,39,0.59,149,1675.15,11.49,9.13,181,236,36,68,2.2825,15.74420892
2898,204,34,245,17,44,12,90,24,2584,1.64,38,0.64,157,1587.11,13,9.2,170,228,32,66,2.3,17.28937088
3132,209,35,254,22,42,10,88,24,2453,1.99,47,0.6,152,1615.23,11.01,9.12,174,232,32,64,2.28,13.6428044
3123,249,41,275,19,55,12,111,29,2471,2.08,47,0.64,177,1709.15,9.95,9.12,208,256,43,82,2.28,13.5518864
3096,234,38,265,21,43,11,85,22,2437,2.29,51,0.63,167,1551.79,8.29,9.14,196,244,32,63,2.285,9.393348991
3141,255,43,281,25,53,12,94,25,2630,2.05,46,0.6,170,1618.25,8.38,9.18,212,256,41,69,2.295,10.73972193
3123,201,34,241,18,39,10,77,20,2470,1.63,37,0.63,151,1670.09,12.17,9.2,167,223,29,57,2.3,14.56037154
2952,269,44,334,29,58,14,105,28,2603,2.37,54,0.59,197,1482.56,11.02,9.17,225,305,44,77,2.2925,14.65111365
3042,217,36,250,18,46,11,100,26,2580,2.01,46,0.62,156,1653.46,10.24,9.23,181,232,35,74,2.3075,13.38478451
3096,209,34,230,15,40,10,80,22,2463,1.85,43,0.61,140,1772.74,13.24,9.18,175,215,30,58,2.295,15.62481988
2952,259,43,301,18,51,12,101,26,2451,2.32,52,0.63,189,1536.58,10.06,9.17,216,283,39,75,2.2925,12.21466954
3060,229,37,269,22,49,12,94,24,2443,1.87,42,0.62,168,1647.75,9.07,9.18,192,247,37,70,2.295,11.96688766
2934,207,32,246,22,43,10,84,22,2514,1.9,44,0.65,160,1463.68,9.84,9.19,175,224,33,62,2.2975,12.60394612
3132,213,36,256,23,46,11,100,26,2672,1.7,38,0.59,152,1724.03,12.41,9.2,177,233,35,74,2.3,16.52583221
3132,237,39,292,21,47,11,95,24,2491,1.93,43,0.62,182,1763.1,10.3,9.17,198,271,36,71,2.2925,12.59505493
2988,201,34,224,22,42,10,85,21,2464,1.85,44,0.65,147,1677.14,9.98,9.15,167,202,32,64,2.2875,12.85870117
2916,252,40,301,25,55,12,107,29,2482,2.24,53,0.63,189,1477.53,10.25,9.14,212,276,43,78,2.285,13.79428973
2943,202,33,226,18,40,9,88,22,2479,1.65,38,0.59,133,1577.98,12.96,9.18,169,208,31,66,2.295,15.82438909
2970,227,38,275,24,52,13,97,24,2478,1.95,43,0.6,164,1491.69,11.01,9.17,189,251,39,73,2.2925,15.55170948
3114,250,40,284,23,54,13,100,25,2667,2.11,50,0.61,172,1552.76,8.81,9.14,210,261,41,75,2.285,11.73391638
3069,241,40,269,16,50,12,98,26,2432,2.12,48,0.65,174,1712.6,8.95,9.2,201,253,38,72,2.3,11.44957395
2907,220,37,254,15,43,10,86,22,2486,2.03,46,0.6,152,1597.55,11.53,9.21,183,239,33,64,2.3025,13.89595539
2916,269,43,322,25,54,13,112,28,2670,2.65,62,0.61,197,1590.32,8.05,9.15,226,297,41,84,2.2875,9.964389363
2943,201,33,234,19,44,11,86,23,2451,1.61,37,0.6,140,1577.34,9.32,9.22,168,215,33,63,2.305,12.58015119
2979,214,36,255,22,50,11,87,21,2411,1.95,44,0.63,162,1572.46,9.48,9.14,178,233,39,66,2.285,13.65771034
3069,220,36,270,24,50,12,95,24,2602,1.79,43,0.64,171,1773.92,12.71,9.13,184,246,38,71,2.2825,17.81173411
3087,200,33,236,19,45,11,79,20,2459,1.87,44,0.59,140,1551.09,13.77,9.12,167,217,34,59,2.28,19.10424098
3141,200,33,237,18,39,9,73,19,2432,1.69,39,0.62,148,1635.01,11.73,9.22,167,219,30,54,2.305,14.10411865
2889,243,41,284,22,50,12,92,24,2638,2.12,49,0.65,185,1622.97,11.77,9.23,202,262,38,68,2.3075,14.93322205
2943,234,38,270,22,49,11,99,25,2471,1.87,43,0.62,169,1545.14,11.96,9.19,196,248,38,74,2.2975,15.44275323
3105,236,40,258,18,48,11,90,23,2499,2.18,52,0.59,153,1755.77,8.32,9.17,196,240,37,67,2.2925,10.43436177
2934,230,38,277,21,53,13,111,29,2436,1.98,47,0.63,174,1666.05,11.48,9.13,192,256,40,82,2.2825,16.31185119
2907,236,39,280,22,55,13,105,27,2645,1.88,41,0.62,174,1650.53,11.9,9.21,197,258,42,78,2.3025,17.10058538
2952,207,34,243,20,46,12,90,24,2490,2.02,45,0.65,159,1636.9,13.43,9.17,173,223,34,66,2.2925,18.40250007
2916,217,35,264,23,47,11,89,23,2606,1.82,43,0.62,165,1625.5,10.02,9.21,182,241,36,66,2.3025,13.38194298
3123,261,43,324,29,48,11,98,24,2597,2.29,51,0.6,193,1690.47,7.79,9.18,218,295,37,74,2.295,8.833880437
3087,206,34,245,16,48,12,89,23,2434,1.93,43,0.61,150,1642.47,9.77,9.16,172,229,36,66,2.29,14.03724597
2979,252,42,293,20,54,13,95,24,2591,2.14,48,0.61,177,1721.07,8.09,9.14,210,273,41,71,2.285,10.68944286
2943,222,37,249,19,49,12,99,26,2665,1.77,42,0.64,159,1552.78,11.91,9.19,185,230,37,73,2.2975,16.20944691
3069,240,39,278,19,52,12,91,24,2637,2.31,55,0.66,183,1666.74,9.77,9.19,201,259,40,67,2.2975,13.05268913
2961,209,35,243,23,41,10,75,20,2647,1.98,44,0.65,157,1670.91,14.46,9.19,174,220,31,55,2.2975,17.49118337
2916,258,42,301,23,51,12,92,23,2572,2.33,54,0.63,191,1629.67,9.54,9.19,216,278,39,69,2.2975,11.62819147
3042,215,35,238,17,40,10,80,21,2688,1.91,44,0.65,155,1534.26,11.52,9.14,180,221,30,59,2.285,13.21561383
3123,234,38,263,22,48,12,103,27,2611,1.97,44,0.63,166,1684.36,10.32,9.17,196,241,36,76,2.2925,13.05324251
3141,222,35,260,21,45,11,87,23,2431,1.86,43,0.65,168,1659.16,8.92,9.13,187,239,34,64,2.2825,11.1490464
2880,252,42,285,17,55,13,104,27,2600,2.46,58,0.63,179,1657.79,7.86,9.13,210,268,42,77,2.2825,10.5778651
2934,243,40,269,22,49,12,95,25,2482,2,46,0.61,165,1500.09,8.15,9.2,203,247,37,70,2.3,10.13352969
2934,253,42,304,27,54,12,101,25,2625,2.2,51,0.63,191,1685.89,9.19,9.19,211,277,42,76,2.2975,12.09489436
3069,230,38,276,20,49,12,93,23,2672,2.25,53,0.6,165,1691.06,9.92,9.15,192,256,37,70,2.2875,13.0314651
2988,214,34,259,16,39,9,84,21,2578,2.03,45,0.63,164,1622.37,11.47,9.15,180,243,30,63,2.2875,12.88924803
2988,252,41,289,28,49,12,101,27,2574,2.37,54,0.6,175,1571.4,8.16,9.13,211,261,37,74,2.2825,9.783607634
3078,266,43,329,22,54,13,111,28,2411,2.26,50,0.63,207,1589.12,8.38,9.16,223,307,41,83,2.29,10.48985466
2988,226,36,252,17,45,12,95,23,2457,2.16,49,0.6,152,1536.02,12.16,9.15,190,235,33,72,2.2875,14.92969649
2907,201,33,225,20,38,9,78,21,2696,1.88,43,0.64,144,1575.64,14.41,9.17,168,205,29,57,2.2925,16.79828129
3087,265,42,320,23,53,12,106,27,2520,2.4,56,0.62,198,1715.3,9.29,9.16,223,297,41,79,2.29,11.45668676
2889,226,37,262,23,51,11,91,23,2439,2.02,45,0.61,161,1590.72,10.76,9.24,189,239,40,68,2.31,14.97225922
3033,252,40,275,19,51,13,107,28,2699,2.45,54,0.65,178,1656.25,11.59,9.23,212,256,38,79,2.3075,14.4632669
2943,230,37,256,18,48,11,87,23,2552,2.01,44,0.6,153,1466.21,8.43,9.15,193,238,37,64,2.2875,10.84811562
2907,212,35,251,18,48,12,87,23,2419,2.07,49,0.66,165,1614.84,9.42,9.2,177,233,36,64,2.3,13.15132797
3096,213,35,254,20,51,12,97,24,2654,1.9,44,0.63,160,1766.22,9.84,9.21,178,234,39,73,2.3025,14.5277715
2934,241,39,285,23,51,12,100,25,2677,1.99,45,0.63,178,1635.19,11.93,9.13,202,262,39,75,2.2825,15.56707101
2997,229,39,274,20,46,12,88,23,2557,1.83,43,0.61,167,1629.33,10.81,9.14,190,254,34,65,2.285,13.38940791
3033,254,41,303,22,50,12,95,24,2409,2.32,51,0.64,193,1559.59,10.66,9.19,213,281,38,71,2.2975,12.939182
2970,248,40,280,19,56,14,119,29,2696,2.05,49,0.62,174,1553.51,10.85,9.22,208,261,42,90,2.305,15.1070412
2970,249,40,295,22,54,12,106,28,2437,2.09,46,0.65,191,1480.04,8.47,9.2,209,273,42,78,2.3,11.32638063
2889,244,40,301,26,53,13,103,27,2593,2.01,49,0.59,179,1444.56,11.5,9.17,204,275,40,76,2.2925,15.40271263
2907,235,39,267,18,48,12,89,23,2654,2.29,52,0.65,173,1567.99,12.24,9.17,196,249,36,66,2.2925,15.41587294
3042,210,34,245,23,37,10,83,22,2485,1.99,47,0.66,161,1518.88,11.62,9.23,176,222,27,61,2.3075,12.62414246
2979,269,44,295,24,50,12,90,24,2538,2.51,58,0.64,188,1539.13,8.51,9.15,225,271,38,66,2.2875,9.753502816
3132,251,40,285,19,48,12,86,22,2408,2.26,54,0.64,182,1689.31,8.65,9.17,211,266,36,64,2.2925,10.19992439
3132,207,35,226,18,43,10,86,23,2503,1.89,45,0.61,138,1705.55,12.52,9.21,172,208,33,63,2.3025,16.03672819
3123,218,37,245,19,40,9,83,22,2419,1.75,42,0.61,150,1805.57,11.17,9.13,181,226,31,61,2.2825,12.63775699
3105,257,41,306,20,52,13,95,24,2470,2.29,53,0.59,182,1654.25,9.69,9.14,216,286,39,71,2.285,12.0894718
2943,253,41,292,20,52,12,106,28,2508,2.33,54,0.64,186,1552.42,8.73,9.24,212,272,40,78,2.31,11.06395487
3132,223,37,267,15,44,10,84,22,2542,2,47,0.62,165,1753.09,11.42,9.13,186,252,34,62,2.2825,13.89399847
3132,267,44,316,27,57,13,118,29,2601,2.18,49,0.65,206,1738.51,7.89,9.17,223,289,44,89,2.2925,10.38613413
3141,226,37,276,23,47,12,101,26,2675,2.03,46,0.62,170,1565.11,12.47,9.2,189,253,35,75,2.3,15.99076355
3024,252,41,276,18,47,12,99,26,2480,2.24,54,0.62,172,1684.91,7.96,9.22,211,258,35,73,2.305,9.154269928
3114,261,42,315,20,50,12,100,25,2688,2.22,50,0.63,197,1602.18,10.21,9.19,219,295,38,75,2.2975,12.0605904
3042,233,39,283,20,50,12,92,24,2601,2.11,47,0.64,181,1598.22,10.27,9.14,194,263,38,68,2.285,13.58932409
3078,263,43,301,26,49,11,89,23,2570,2.51,60,0.66,198,1553.12,8.01,9.18,220,275,38,66,2.295,9.202083651
2889,241,38,294,22,51,13,95,24,2561,2.02,45,0.65,191,1633.79,11.69,9.17,203,272,38,71,2.2925,15.25390277
3096,206,33,235,21,42,10,88,23,2416,1.92,43,0.61,143,1568.01,11.51,9.14,173,214,32,65,2.285,14.47007303
3078,262,43,300,22,57,13,115,29,2484,2.33,55,0.65,195,1523.19,9.94,9.21,219,278,44,86,2.3025,13.33439384
3060,264,43,327,30,55,13,110,29,2465,2.35,52,0.62,201,1587.79,9.99,9.16,221,297,42,81,2.29,12.83327735
2898,224,38,272,23,51,12,103,26,2419,2.01,46,0.64,174,1498.64,11.95,9.14,186,249,39,77,2.285,16.77657846
3114,261,41,312,21,55,13,109,27,2515,2.2,49,0.62,193,1579.31,10.46,9.13,220,291,42,82,2.2825,13.59149394
2997,242,39,282,18,53,13,106,27,2579,1.98,45,0.64,180,1667.38,10.65,9.23,203,264,40,79,2.3075,14.38213764
2880,212,36,235,18,42,11,80,21,2486,1.94,44,0.59,140,1563.19,9.99,9.24,176,217,31,59,2.31,12.20372034
3006,268,42,326,21,57,13,107,27,2484,2.24,53,0.65,211,1517.82,7.04,9.13,226,305,44,80,2.2825,9.232643151
2880,234,39,259,22,48,11,96,25,2493,1.86,43,0.64,166,1488.79,8.4,9.19,195,237,37,71,2.2975,10.62473227
3132,246,40,284,20,52,12,101,26,2674,1.98,44,0.64,182,1695.39,9.83,9.22,206,264,40,75,2.305,12.81253556
3087,250,41,300,26,45,11,93,24,2621,2.23,51,0.66,198,1765.34,9.11,9.19,209,274,34,69,2.2975,10.11123517
2907,229,38,260,16,46,11,91,23,2673,1.94,46,0.63,165,1569.97,10.16,9.15,191,244,35,68,2.2875,12.58430938
2988,230,37,276,24,47,11,86,22,2440,1.95,46,0.61,169,1553.6,10.36,9.18,193,252,36,64,2.295,13.05398492
2997,262,44,321,20,54,12,98,26,2425,2.49,56,0.64,206,1540.76,8.66,9.15,218,301,42,72,2.2875,11.00585254
3141,246,38,297,25,47,12,86,23,2543,2.42,55,0.6,178,1599.54,10.06,9.14,208,272,35,63,2.285,11.85152019
3132,243,41,292,24,51,12,110,29,2673,1.93,45,0.59,173,1730.1,10.97,9.21,202,268,39,81,2.3025,14.19658409
2988,220,36,253,19,50,12,95,25,2520,2.1,48,0.65,165,1629.55,10.63,9.2,184,234,38,70,2.3,14.89683191
2988,254,40,312,22,51,12,104,27,2555,2.05,47,0.6,188,1520.43,7.95,9.15,214,290,39,77,2.2875,9.842760493
3042,202,35,244,17,50,11,88,23,2411,1.7,40,0.64,155,1663.89,13.1,9.17,167,227,39,65,2.2925,19.99416445
3033,226,37,248,18,47,11,92,23,2699,1.97,47,0.61,151,1697.84,10.84,9.22,189,230,36,69,2.305,13.90055147
2880,264,42,304,20,52,13,97,25,2475,2.57,58,0.6,183,1421.12,9.88,9.24,222,284,39,72,2.31,11.99968072
3078,250,42,298,22,48,12,100,26,2448,1.99,45,0.65,195,1705.4,9.4,9.23,208,276,36,74,2.3075,11.12864815
3060,205,33,240,15,41,10,78,20,2559,1.91,45,0.64,154,1561.93,10.09,9.21,172,225,31,58,2.3025,12.44326904
2988,257,41,294,22,60,14,110,27,2561,2.46,56,0.6,177,1499.12,8.07,9.23,216,272,46,83,2.3075,11.61729429
3069,239,39,288,25,47,11,88,22,2624,2.28,51,0.62,178,1666.88,9.3,9.15,200,263,36,66,2.2875,11.27706892
2970,213,35,248,21,47,11,82,21,2683,2.04,46,0.62,153,1551.54,13.97,9.23,178,227,36,61,2.3075,19.00763089
3123,235,37,287,17,45,11,84,22,2652,2.26,52,0.63,182,1627.11,8.58,9.17,198,270,34,62,2.2925,10.13083562
3078,210,34,242,18,44,11,80,22,2670,1.72,40,0.61,147,1544.59,14.06,9.13,176,224,33,58,2.2825,18.16485902
2979,244,40,301,26,54,13,105,27,2563,2.27,54,0.6,180,1708.97,8.2,9.16,204,275,41,78,2.29,11.1900265
3114,252,40,293,23,55,14,109,28,2590,2.4,55,0.61,178,1775.14,8.26,9.18,212,270,41,81,2.295,11.11617884
3123,232,38,274,23,46,11,89,23,2542,1.9,42,0.61,167,1678.16,9.7,9.2,194,251,35,66,2.3,11.85918681
3087,267,44,317,22,52,12,106,27,2549,2.19,51,0.65,207,1573.78,9.02,9.18,223,295,40,79,2.295,10.83208225
3042,217,35,241,16,48,11,98,26,2555,1.84,43,0.59,143,1752.25,12.58,9.12,182,225,37,72,2.28,17.15834808
2997,226,38,255,19,47,10,83,21,2526,1.96,43,0.62,159,1560.4,12.32,9.13,188,236,37,62,2.2825,15.79841274
2943,229,37,283,20,45,11,86,22,2524,2.05,46,0.63,177,1686.79,10.33,9.21,192,263,34,64,2.3025,12.51672418
2943,249,41,280,18,53,13,92,24,2453,2.06,48,0.59,167,1627.56,10.75,9.2,208,262,40,68,2.3,14.10906766
3024,253,41,314,29,50,12,93,24,2696,2.03,48,0.63,197,1586.44,8.82,9.19,212,285,38,69,2.2975,10.74809255
3024,261,44,314,21,57,13,114,30,2604,2.52,57,0.64,201,1600.38,8.61,9.16,217,293,44,84,2.29,11.59446807
2898,248,41,274,25,49,11,94,24,2427,2.1,50,0.64,176,1449.18,7.88,9.21,207,249,38,70,2.3025,9.600281021
2952,200,34,237,15,46,11,96,24,2436,1.7,39,0.62,148,1660.87,9.7,9.13,166,222,35,72,2.2825,13.7566567
2952,214,34,257,20,42,11,77,21,2408,1.88,43,0.64,165,1495.95,9.72,9.14,180,237,31,56,2.285,11.76291913
3078,231,39,279,16,45,12,87,23,2463,1.94,47,0.63,175,1747.66,10.33,9.21,192,263,33,64,2.3025,12.40835427
2979,206,34,252,19,39,9,78,20,2514,1.76,38,0.64,162,1500.19,11.08,9.15,172,233,30,58,2.2875,12.93452475
3087,201,34,245,23,41,10,78,20,2671,1.63,38,0.66,162,1782.24,14.23,9.14,167,222,31,58,2.285,17.89806284
2943,263,43,297,24,57,12,114,29,2499,2.12,48,0.62,184,1470.16,10.55,9.13,220,273,45,85,2.2825,14.09888915
2943,225,35,250,20,48,12,86,22,2666,1.84,44,0.65,164,1470.19,10.2,9.22,190,230,36,64,2.305,13.41751904
3042,265,43,308,21,48,11,84,22,2588,2.21,50,0.62,192,1510.75,7.63,9.18,222,287,37,62,2.295,8.521837149
3114,201,33,229,18,45,10,81,21,2613,1.77,42,0.63,145,1685.33,12.28,9.22,168,211,35,60,2.305,16.95228138
3069,228,36,271,16,48,12,94,25,2655,1.93,44,0.6,162,1696.67,11.1,9.2,192,255,36,69,2.3,14.40929386
3078,205,34,235,19,42,10,78,21,2669,1.73,42,0.6,141,1738.75,11.98,9.13,171,216,32,57,2.2825,15.13441284
3087,269,43,297,22,53,13,105,26,2597,2.58,57,0.63,187,1690.75,8.67,9.2,226,275,40,79,2.3,10.53309537
2898,229,38,268,26,43,11,82,21,2517,2.16,52,0.6,160,1578.23,12.07,9.17,191,242,32,61,2.2925,13.97505651
2961,249,39,282,18,50,11,92,24,2588,2,45,0.66,185,1554.71,8.08,9.19,210,264,39,68,2.2975,10.00449905
2898,219,36,244,21,43,10,81,21,2443,2.05,48,0.62,151,1649.67,11.33,9.19,183,223,33,60,2.2975,13.71726662
2934,234,38,271,21,48,11,89,24,2472,2.28,51,0.62,169,1542.62,8.92,9.13,196,250,37,65,2.2825,11.28245379
3141,212,36,251,18,39,10,77,20,2654,1.82,42,0.59,149,1708.5,11.73,9.22,176,233,29,57,2.305,13.30577231
3051,252,40,279,16,60,14,124,32,2564,2.29,53,0.66,184,1656.72,8.76,9.19,212,263,46,92,2.2975,12.86080475
3096,200,33,245,17,43,11,75,19,2409,1.72,41,0.61,151,1758.13,11.03,9.21,167,228,32,56,2.3025,14.62269096
2898,227,37,261,19,49,13,107,28,2566,1.83,43,0.61,159,1483.43,9.36,9.14,190,242,36,79,2.285,12.45831768
2979,217,36,258,19,45,10,93,24,2544,2.05,46,0.66,170,1651.5,9.05,9.22,181,239,35,69,2.305,11.57216689
3024,220,37,242,20,43,11,81,21,2528,1.79,42,0.63,153,1553.02,11.66,9.21,183,222,32,60,2.3025,14.05263139
2970,250,40,280,23,45,11,98,25,2666,2.08,49,0.64,181,1692.46,10.15,9.14,210,257,34,73,2.285,11.26553644
3024,243,41,294,23,48,12,86,22,2581,2.11,47,0.62,182,1598.61,10.03,9.12,202,271,36,64,2.28,12.21656826
3087,201,33,243,22,36,10,74,19,2495,1.86,42,0.62,150,1710.54,13.17,9.22,168,221,26,55,2.305,14.54472611
3087,210,34,247,22,45,11,88,23,2484,2.03,46,0.61,150,1640.35,10.7,9.21,176,225,34,65,2.3025,14.13807646
2943,253,41,292,23,53,13,106,27,2489,2.15,48,0.65,189,1601.66,10.44,9.13,212,269,40,79,2.2825,13.48556592
2997,246,41,284,23,57,14,111,28,2474,1.98,44,0.61,173,1637.2,9.88,9.14,205,261,43,83,2.285,14.11594711
2880,249,43,278,16,45,11,84,22,2500,1.97,46,0.65,182,1555.68,11.65,9.24,206,262,34,62,2.31,12.98232333
3078,267,45,316,23,55,13,107,27,2451,2.23,50,0.63,199,1639.52,8.52,9.19,222,293,42,80,2.2975,10.82192082
3042,268,42,320,20,50,13,87,22,2637,2.61,61,0.61,194,1542.28,9.64,9.14,226,300,37,65,2.285,11.08984748
3069,253,41,311,23,56,13,103,26,2500,2.11,48,0.61,188,1572.56,9.6,9.18,212,288,43,77,2.295,13.10243664
3006,231,38,255,21,45,11,87,23,2457,1.95,43,0.62,157,1675.89,11.38,9.13,193,234,34,64,2.2825,13.66961003
3042,202,32,239,13,41,10,80,20,2645,1.71,42,0.63,150,1620.07,12.1,9.15,170,226,31,60,2.2875,15.14367173
3015,204,34,249,18,40,9,86,22,2466,1.81,42,0.64,160,1603.31,12.65,9.21,170,231,31,64,2.3025,15.29444347
2889,206,35,235,19,41,10,78,20,2629,1.7,37,0.59,139,1448.25,13.92,9.24,171,216,31,58,2.31,17.08319904
3060,241,39,280,21,42,11,86,22,2457,2.04,48,0.59,165,1605.77,8.51,9.19,202,259,31,64,2.2975,9.144819486
3015,213,35,247,20,47,11,89,24,2682,1.91,44,0.64,158,1649.27,11.78,9.12,178,227,36,65,2.28,16.02790923
2943,268,44,306,24,56,13,106,28,2471,2.51,59,0.63,194,1483.62,10.35,9.19,224,282,43,78,2.2975,13.33542656
3006,234,39,284,18,44,10,82,22,2529,2.08,46,0.65,186,1596.6,11.57,9.17,195,266,34,60,2.2925,13.41477854
3024,253,41,280,17,52,12,98,25,2554,2.17,51,0.62,174,1517.17,8.04,9.14,212,263,40,73,2.285,10.18948421
2907,223,38,248,22,45,12,96,26,2692,2.17,51,0.61,151,1572.12,11.74,9.14,185,226,33,70,2.285,14.60794338
2943,238,40,289,22,45,11,82,21,2433,2.12,51,0.61,176,1678.95,8.57,9.13,198,267,34,61,2.2825,9.991477343
2925,200,33,218,17,38,10,69,18,2410,1.82,43,0.61,134,1632.64,9.81,9.2,167,201,28,51,2.3,11.49306698
2961,262,41,293,22,51,13,95,24,2524,2.23,50,0.62,182,1696.24,8.32,9.17,221,271,38,71,2.2925,9.986321424
2979,251,42,307,22,56,13,108,27,2681,2.24,52,0.62,189,1545.09,10.4,9.16,209,285,43,81,2.29,14.3074084
3078,231,39,262,21,44,11,90,23,2683,2.13,49,0.62,162,1728.4,12.86,9.15,192,241,33,67,2.2875,15.10410494
3123,212,36,256,20,38,10,74,19,2466,1.78,39,0.64,164,1623.18,9.84,9.19,176,236,28,55,2.2975,10.87567356
2934,269,44,322,24,64,14,115,31,2594,2.28,52,0.64,206,1534.62,8.83,9.18,225,298,50,84,2.295,12.9539354
2970,244,39,282,23,53,12,104,27,2695,2.19,52,0.61,172,1630.9,10.39,9.22,205,259,41,77,2.305,13.91601602
3114,256,41,298,23,47,12,99,26,2582,2.29,55,0.63,188,1779.42,10.21,9.15,215,275,35,73,2.2875,11.55837988
3006,262,42,312,21,52,13,105,28,2508,2.15,50,0.6,187,1705.86,7.57,9.22,220,291,39,77,2.305,9.264271223
3123,211,35,250,17,42,10,80,20,2664,1.82,43,0.6,149,1586.26,11.42,9.17,176,233,32,60,2.2925,14.01671582
2889,217,35,263,23,44,11,84,21,2698,1.76,41,0.59,155,1463.2,9.86,9.24,182,240,33,63,2.31,12.32773207
2943,243,40,284,19,53,12,97,25,2445,2.11,48,0.65,185,1605.14,9.59,9.15,203,265,41,72,2.2875,12.89738109
3006,218,35,268,20,50,12,102,27,2569,1.76,42,0.61,162,1695.92,12.4,9.23,183,248,38,75,2.3075,17.53672635
2925,233,38,283,18,52,12,91,23,2568,1.91,45,0.59,168,1489.73,9.67,9.14,195,265,40,68,2.285,13.3072166
3024,255,41,281,18,53,12,101,26,2475,2.51,59,0.61,173,1631.87,9.87,9.21,214,263,41,75,2.3025,12.64929063
2889,230,37,285,18,55,12,103,27,2570,2.26,52,0.65,184,1524.33,12.11,9.14,193,267,43,76,2.285,17.85633503
3123,242,39,285,25,46,11,89,23,2454,2.2,49,0.65,186,1760.19,8.18,9.15,203,260,35,66,2.2875,9.58758216
2934,205,33,230,17,42,9,83,22,2606,1.65,39,0.66,151,1607.18,10.43,9.2,172,213,33,61,2.3,13.17628764
3087,263,43,316,25,57,14,116,29,2697,2.55,60,0.6,190,1571.85,9.9,9.19,220,291,43,87,2.2975,13.23023721
2979,267,44,295,21,58,13,111,28,2548,2.38,54,0.66,194,1615.32,10.22,9.16,223,274,45,83,2.29,13.68929105
2916,217,37,263,21,46,12,89,24,2482,2.1,50,0.61,160,1686.46,11.65,9.13,180,242,34,65,2.2825,15.2278066
3015,225,38,255,18,51,12,92,23,2558,1.84,42,0.66,168,1573.83,11.02,9.15,187,237,39,69,2.2875,15.40219373
2898,201,34,234,20,41,10,71,18,2602,1.93,47,0.61,144,1566.55,13.84,9.19,167,214,31,53,2.2975,17.40753266
3060,214,36,246,17,51,12,98,25,2436,2.01,47,0.61,150,1575.79,8.83,9.23,178,229,39,73,2.3075,12.97568923
3132,269,44,331,22,53,13,104,26,2676,2.27,51,0.62,204,1793.82,11.06,9.18,225,309,40,78,2.295,13.43668221
3141,260,42,315,27,57,13,122,31,2489,2.39,55,0.66,207,1620.58,7.32,9.21,218,288,44,91,2.3025,9.895230566
3123,201,32,226,15,44,10,84,21,2642,1.87,42,0.61,139,1661.9,11.21,9.2,169,211,34,63,2.3,15.13127627
2970,260,41,287,26,54,12,105,27,2465,2.2,49,0.61,175,1705.86,10.69,9.15,219,261,42,78,2.2875,13.69025212
3060,232,39,283,22,46,11,89,24,2464,2.01,46,0.6,169,1643.9,8.94,9.16,193,261,35,65,2.29,10.93001341
3123,260,41,290,22,55,13,107,28,2479,2.28,54,0.62,181,1721.04,10.04,9.19,219,268,42,79,2.2975,13.09593116
2880,240,39,296,21,49,11,105,26,2598,2.19,49,0.6,176,1428.64,9.39,9.19,201,275,38,79,2.2975,11.82125974
2907,226,35,262,18,49,11,92,23,2632,1.92,43,0.63,165,1480.54,9.69,9.14,191,244,38,69,2.285,12.95462206
3096,231,37,282,19,51,11,106,26,2534,1.85,44,0.63,178,1645.36,9.78,9.17,194,263,40,80,2.2925,13.31405603
2952,229,37,253,22,48,11,96,24,2554,1.88,43,0.6,152,1522.91,12.74,9.21,192,231,37,72,2.3025,16.46601521
3141,218,34,258,21,42,10,82,21,2687,2.13,47,0.63,163,1747.6,9.98,9.19,184,237,32,61,2.2975,11.85595842
2961,214,35,252,20,46,11,90,24,2578,1.78,39,0.64,161,1551.01,9.33,9.16,179,232,35,66,2.29,12.36627874
2925,261,42,304,25,58,13,114,29,2443,2.53,59,0.63,193,1651.29,10.49,9.22,219,279,45,85,2.305,14.37395575
2925,268,42,326,24,59,14,103,27,2406,2.46,57,0.64,210,1641.2,7.78,9.15,226,302,45,76,2.2875,10.56112405
3123,209,34,235,20,46,11,88,23,2408,2.01,46,0.63,147,1625.01,9.44,9.13,175,215,35,65,2.2825,12.8114082
2988,257,42,314,26,52,12,108,27,2586,2.22,52,0.62,196,1481.4,8.49,9.2,215,288,40,81,2.3,10.59232359
2907,255,43,303,18,53,12,92,24,2700,2.26,52,0.6,183,1577.72,12.06,9.15,212,285,41,68,2.2875,15.45597214
3069,221,36,253,20,41,11,84,22,2679,2.02,48,0.62,158,1720.67,11.26,9.2,185,233,30,62,2.3,12.88081382
3033,221,37,249,19,40,10,76,20,2455,1.92,42,0.63,157,1539.7,9.2,9.17,184,230,30,56,2.2925,10.26759841
2889,200,33,232,20,45,11,89,22,2657,1.73,42,0.65,151,1628.25,12.68,9.24,167,212,34,67,2.31,17.59199532
3078,213,34,241,20,42,10,77,20,2471,1.77,43,0.64,154,1627.43,8.85,9.21,179,221,32,57,2.3025,10.76034725
3006,251,41,278,20,51,12,106,27,2627,2.22,50,0.63,177,1606.21,8.42,9.21,210,258,39,79,2.3025,10.54925707
3015,230,37,281,21,51,12,92,23,2679,2.21,53,0.61,170,1567.92,10.26,9.18,193,260,39,69,2.295,14.02823492
2997,212,33,254,20,48,11,84,22,2417,2.1,47,0.64,162,1505.52,8.8,9.17,179,234,37,62,2.2925,12.28574163
2979,206,33,255,23,47,11,94,24,2544,1.84,40,0.59,152,1556.64,12.36,9.18,173,232,36,70,2.295,17.38851273
2961,236,39,272,21,48,12,87,22,2500,2.29,53,0.65,177,1592.87,8.72,9.23,197,251,36,65,2.3075,10.93601378
2988,209,36,235,20,45,11,88,23,2563,1.83,43,0.62,145,1646.67,10.86,9.23,173,215,34,65,2.3075,14.41814478
2988,231,38,254,17,44,10,96,24,2443,1.91,44,0.6,152,1649.37,9.35,9.17,193,237,34,72,2.2925,10.98160041
2952,246,40,271,19,51,12,103,26,2698,2.33,55,0.63,172,1468.98,10.57,9.16,206,252,39,77,2.29,13.51211664
2961,223,36,265,16,45,12,86,23,2599,2.11,49,0.65,173,1695.21,9.69,9.22,187,249,33,63,2.305,12.05715259
2880,218,36,239,18,45,11,79,21,2491,1.84,42,0.64,154,1464.53,11.47,9.15,182,221,34,58,2.2875,14.59932469
3141,219,36,256,19,42,10,76,20,2615,1.81,43,0.66,169,1716.86,9.44,9.18,183,237,32,56,2.295,11.1632461
2898,222,38,249,22,47,12,92,24,2425,2,46,0.63,156,1558.95,9.68,9.19,184,227,35,68,2.2975,12.63669694
2916,231,40,255,21,54,12,109,28,2444,1.88,44,0.64,163,1677.54,8.85,9.18,191,234,42,81,2.295,12.7567011
2916,215,33,250,16,42,11,78,21,2593,1.84,42,0.64,159,1565.3,12.95,9.16,182,234,31,57,2.29,15.59889836
2970,256,42,312,23,51,12,94,24,2629,2.18,48,0.61,190,1659.17,8.72,9.15,214,289,39,70,2.2875,10.71174006
2997,249,39,283,16,48,12,94,23,2525,2.16,49,0.59,167,1615.63,8.69,9.13,210,267,36,71,2.2825,10.32939763
2880,265,43,300,22,51,13,89,23,2496,2.17,50,0.61,183,1566.95,8.22,9.13,222,278,38,66,2.2825,9.754599633
2979,265,42,320,27,55,14,105,27,2557,2.45,57,0.62,199,1656.36,10.67,9.15,223,293,41,78,2.2875,13.65508992
3078,252,41,303,20,59,14,103,26,2540,2.09,47,0.64,194,1753.55,11.13,9.23,211,283,45,77,2.3075,16.06793124
2979,218,36,265,22,44,11,95,24,2612,1.77,40,0.65,172,1509.85,10.78,9.14,182,243,33,71,2.285,13.41616136
3015,216,36,262,24,46,11,91,23,2560,2.09,50,0.64,166,1510.65,9.1,9.15,180,238,35,68,2.2875,11.94974952
3060,211,35,233,19,36,9,68,17,2674,2.01,45,0.61,141,1705.39,11.65,9.21,176,214,27,51,2.3025,12.25629767
3141,215,36,238,20,44,11,84,22,2605,1.9,45,0.61,145,1768.28,9.76,9.16,179,218,33,62,2.29,12.31621789
3132,226,37,249,20,45,11,90,23,2624,1.95,46,0.62,155,1699.55,9.98,9.2,189,229,34,67,2.3,12.2531555
3069,266,44,327,23,56,14,109,27,2607,2.41,56,0.63,206,1690.78,8,9.19,222,304,42,82,2.2975,10.38507666
3105,222,34,247,15,41,10,85,21,2486,1.83,44,0.6,148,1635.95,10.69,9.16,188,232,31,64,2.29,12.17368098
3123,227,37,271,17,50,12,95,26,2626,2.12,49,0.65,177,1713.07,12.59,9.14,190,254,38,69,2.285,17.09949193
3051,225,38,265,20,43,10,84,22,2695,2,47,0.64,171,1661.16,9.81,9.12,187,245,33,62,2.28,11.56027789
3060,262,42,313,21,52,13,91,24,2508,2.19,52,0.6,187,1603.8,8.13,9.2,220,292,39,67,2.3,9.949607007
2934,228,37,272,21,45,11,87,22,2457,2.15,49,0.61,167,1681.47,10.82,9.13,191,251,34,65,2.2825,13.16795267
3132,258,43,295,28,48,12,89,23,2556,2.13,49,0.6,177,1640.31,10.01,9.21,215,267,36,66,2.3025,11.48335889
2943,232,39,278,22,52,12,103,27,2427,2.21,52,0.59,164,1648.51,10.47,9.21,193,256,40,76,2.3025,14.47022785
3105,208,35,256,18,49,11,98,25,2692,1.82,40,0.61,158,1585.34,10.81,9.21,173,238,38,73,2.3025,15.70260725
2907,222,36,254,23,47,11,83,22,2417,1.87,43,0.64,162,1581.84,8.78,9.13,186,231,36,61,2.2825,11.46179743
2979,209,34,249,19,44,10,90,22,2626,1.77,39,0.64,160,1687.72,14.25,9.15,175,230,34,68,2.2875,18.4984178
3060,227,36,267,25,48,11,100,25,2688,1.82,44,0.59,159,1523.92,10.17,9.2,191,242,37,75,2.3,13.26018742
3105,237,39,275,21,50,11,93,25,2576,2.16,48,0.59,163,1697.1,9.09,9.13,198,254,39,68,2.2825,11.82493796
3096,213,34,262,19,45,10,93,23,2431,1.97,44,0.59,156,1560.02,10.49,9.14,179,243,35,70,2.285,13.66538047
2970,248,41,294,22,53,13,96,26,2451,2.1,49,0.61,179,1505.22,8.02,9.14,207,272,40,70,2.285,10.56846434
3051,215,37,262,18,43,11,84,22,2564,1.77,41,0.62,162,1610.94,10.22,9.13,178,244,32,62,2.2825,12.60358866
2916,269,42,317,21,63,14,116,29,2504,2.35,54,0.65,206,1538.73,7.51,9.14,227,296,49,87,2.285,10.84529915
2997,268,45,308,27,49,12,97,25,2558,2.32,55,0.61,188,1686.55,8.6,9.13,223,281,37,72,2.2825,9.695563755
3105,269,44,330,28,63,15,121,31,2461,2.4,53,0.59,195,1749.28,9.36,9.2,225,302,48,90,2.3,13.51691079
2889,257,42,307,28,49,11,101,25,2501,2.26,53,0.62,190,1508.15,11.04,9.24,215,279,38,76,2.31,12.97912333
3078,268,44,323,27,51,12,87,22,2619,2.19,51,0.61,196,1544.96,8.06,9.18,224,296,39,65,2.295,9.457661218
3105,242,39,271,22,55,13,102,26,2512,2.29,53,0.62,169,1642.01,9.83,9.21,203,249,42,76,2.3025,13.77571568
2997,221,37,258,20,40,10,72,19,2454,1.97,46,0.63,161,1511.36,12.67,9.18,184,238,30,53,2.295,14.14026869
2979,259,42,310,24,57,13,120,30,2433,2.54,58,0.6,185,1696.75,10.38,9.18,217,286,44,90,2.295,14.08593806
2970,203,35,234,20,43,11,88,24,2519,1.78,42,0.61,143,1615.34,10.2,9.22,168,214,32,64,2.305,13.32250582
3141,217,36,239,15,43,11,92,24,2454,1.93,44,0.66,158,1683.99,10.47,9.18,181,224,32,68,2.295,12.79289198
2880,245,40,295,19,50,12,91,23,2644,2.33,55,0.61,179,1634.99,12.11,9.22,205,276,38,68,2.305,15.23917276
2997,225,36,245,20,53,13,106,27,2483,1.84,43,0.59,145,1505.5,10.83,9.17,189,225,40,79,2.2925,15.73023234
3114,261,42,304,21,51,12,103,26,2574,2.53,59,0.65,199,1716.25,9.25,9.14,219,283,39,77,2.285,11.14511953
3141,239,40,281,16,51,12,95,24,2620,2.21,51,0.64,181,1803.36,9.69,9.15,199,265,39,71,2.2875,12.74997642
3123,214,36,246,22,45,11,89,23,2523,1.8,42,0.6,148,1637.33,10.18,9.15,178,224,34,66,2.2875,13.19957195
3078,217,34,243,20,48,11,87,22,2455,1.86,42,0.62,151,1651.45,10.16,9.21,183,223,37,65,2.3025,13.85761658
2916,208,36,253,21,44,11,89,23,2479,1.71,40,0.65,165,1653.67,13.28,9.23,172,232,33,66,2.3075,17.32210815
3051,238,38,264,23,51,12,102,25,2427,2.31,55,0.62,163,1748.66,7.78,9.17,200,241,39,77,2.2925,10.27983503
3015,258,42,309,26,50,11,91,23,2445,2.09,48,0.65,200,1678.31,9.47,9.18,216,283,39,68,2.295,11.31653854
3141,234,39,263,23,48,12,93,24,2610,2.02,47,0.61,160,1596.07,9.79,9.21,195,240,36,69,2.3025,12.38287249
3069,236,39,279,22,56,13,116,30,2610,2.01,47,0.65,182,1596.62,8.56,9.18,197,257,43,86,2.295,12.52457847
2916,269,45,317,21,52,12,97,25,2638,2.28,50,0.64,201,1668.77,7.94,9.23,224,296,40,72,2.3075,9.464221487
2889,242,39,282,26,47,12,84,21,2581,2.16,47,0.61,170,1493.25,11.75,9.24,203,256,35,63,2.31,14.07128268
3060,224,37,266,20,46,11,85,22,2401,1.95,46,0.64,169,1682.3,9.12,9.12,187,246,35,63,2.28,11.54829797
2880,219,36,246,19,52,12,106,27,2698,1.88,44,0.64,158,1549.03,12.4,9.19,183,227,40,79,2.2975,18.15491597
3060,222,35,254,20,45,11,82,21,2485,2.15,50,0.65,166,1734.32,9.52,9.15,187,234,34,61,2.2875,11.89898226
3015,225,37,278,16,51,11,99,26,2515,2,47,0.65,180,1696.8,9.95,9.12,188,262,40,73,2.28,13.90669942
2943,255,41,297,21,52,12,97,24,2605,2.23,50,0.59,176,1485.51,8.46,9.22,214,276,40,73,2.305,10.63767838
3006,221,38,258,18,46,11,86,22,2428,2,45,0.63,164,1679.49,9.95,9.15,183,240,35,64,2.2875,12.77032553
3114,219,37,251,23,42,9,77,19,2558,2.01,46,0.6,150,1569.09,10.33,9.14,182,228,33,58,2.285,12.21571316
3123,222,37,260,18,47,11,99,25,2485,1.86,44,0.62,162,1766.18,10.53,9.17,185,242,36,74,2.2925,13.74632425
2934,232,39,284,24,47,12,89,23,2653,1.97,43,0.6,169,1555.71,11.19,9.19,193,260,35,66,2.2975,13.97826562
3006,239,39,269,20,50,11,94,24,2619,2.25,54,0.63,170,1555.3,11.86,9.14,200,249,39,70,2.285,15.29924931
3132,224,36,276,19,48,12,95,24,2600,1.81,42,0.61,169,1713.77,9.18,9.21,188,257,36,71,2.3025,12.12967681
2988,235,38,287,22,44,11,87,23,2666,2.26,50,0.65,187,1721.93,8.93,9.16,197,265,33,64,2.29,10.30978485
3015,260,43,296,26,49,12,96,25,2520,2.21,50,0.63,186,1581.82,7.93,9.15,217,270,37,71,2.2875,9.215295132
3006,200,34,222,15,36,9,75,19,2622,1.84,44,0.6,133,1577.09,11.87,9.15,166,207,27,56,2.2875,13.17457315
3105,267,44,320,28,50,13,92,23,2594,2.6,59,0.59,190,1759.62,7.5,9.19,223,292,37,69,2.2975,8.660307957
2979,227,38,252,22,41,10,78,20,2587,1.86,42,0.6,152,1582.28,11.01,9.13,189,230,31,58,2.2825,12.26192478
3132,260,41,304,22,52,12,98,26,2422,2.13,50,0.59,181,1668.8,9.68,9.14,219,282,40,72,2.285,11.93764562
2925,213,34,244,19,45,10,93,23,2516,1.82,43,0.6,146,1581.42,12.76,9.19,179,225,35,70,2.2975,16.62252191
2889,210,34,254,22,48,11,99,26,2616,1.69,39,0.64,163,1627.21,12.53,9.2,176,232,37,73,2.3,17.65982286
2889,205,33,237,18,48,11,103,26,2644,1.89,43,0.59,141,1467.15,10.8,9.21,172,219,37,77,2.3025,15.59281266
3141,209,34,237,16,41,9,79,21,2445,1.8,41,0.61,145,1698.37,9.7,9.14,175,221,32,58,2.285,11.73336644
3141,243,40,265,22,47,11,94,25,2485,2.26,51,0.59,157,1638.92,10.26,9.2,203,243,36,69,2.3,12.23636081
3015,241,38,284,22,51,12,87,22,2496,2.03,45,0.62,175,1704.78,10.7,9.12,203,262,39,65,2.28,13.96208381
3015,224,35,252,18,48,12,86,23,2590,2.15,49,0.63,159,1661.93,9.97,9.23,189,234,36,63,2.3075,13.1735161
3033,268,44,301,19,51,12,111,28,2588,2.22,50,0.65,195,1607.19,9.08,9.19,224,282,39,83,2.2975,10.65453646
3114,218,36,253,20,48,11,98,26,2554,2.11,48,0.6,152,1707.92,11.01,9.19,182,233,37,72,2.2975,14.94807926
2898,268,42,322,28,54,14,107,27,2436,2.34,55,0.61,197,1464.16,8.98,9.21,226,294,40,80,2.3025,11.15703079
3105,214,35,240,18,46,11,86,22,2426,1.93,46,0.6,144,1737.03,11.2,9.22,179,222,35,64,2.305,14.84483621
3132,209,34,246,19,44,11,90,22,2611,2.02,48,0.65,160,1748.58,9.63,9.2,175,227,33,68,2.3,12.50103603
2907,224,35,251,22,46,10,92,24,2614,2.02,44,0.65,163,1472.74,12.03,9.19,189,229,36,68,2.2975,15.23311673
2997,244,41,296,20,51,13,98,26,2427,2.24,52,0.64,190,1513.48,10.33,9.22,203,276,38,72,2.305,13.31355389
3051,263,43,292,19,53,12,105,27,2408,2.2,48,0.62,181,1569.06,9.14,9.19,220,273,41,78,2.2975,11.35741895
3015,207,34,240,23,41,10,80,21,2599,1.67,39,0.64,154,1552.06,11.93,9.14,173,217,31,59,2.285,14.57025941
2934,240,41,270,25,46,12,88,22,2550,2.16,50,0.6,163,1597.42,8.41,9.21,199,245,34,66,2.3025,9.939302651
2889,245,39,269,20,44,11,83,22,2596,2,45,0.65,175,1486.02,11.65,9.19,206,249,33,61,2.2975,12.90107342
3105,244,41,285,18,56,13,109,27,2586,2.16,48,0.62,177,1615.57,10.99,9.18,203,267,43,82,2.295,15.55282274
3105,264,45,300,19,48,11,91,23,2511,2.16,51,0.61,182,1701,8.66,9.16,219,281,37,68,2.29,9.708866552
3060,223,38,272,22,44,11,85,21,2594,1.78,42,0.59,162,1695.72,9.41,9.18,185,250,33,64,2.295,11.44855741
2880,201,32,227,17,35,8,71,19,2504,1.74,41,0.63,142,1612.49,14.03,9.22,169,210,27,52,2.305,15.06409297
2934,238,38,270,24,48,11,102,25,2643,2.27,55,0.61,164,1658.37,11.21,9.13,200,246,37,77,2.2825,13.94065637
3006,210,35,244,18,47,12,97,26,2465,1.98,45,0.64,157,1684.5,9.09,9.21,175,226,35,71,2.3025,12.5445699
3060,202,35,247,18,47,12,87,22,2504,1.63,38,0.6,147,1678.02,13.07,9.15,167,229,35,65,2.2875,18.75147371
3114,211,35,230,16,46,12,89,23,2694,1.94,44,0.61,141,1791.37,12.9,9.18,176,214,34,66,2.295,17.34117081
2943,227,37,273,19,50,11,88,23,2494,1.91,44,0.61,166,1608.74,11.84,9.18,190,254,39,65,2.295,16.08085659
2925,233,38,256,18,52,12,92,24,2685,1.86,41,0.63,161,1614.05,8.88,9.18,195,238,40,68,2.295,12.22007067
2988,218,36,242,17,41,10,79,20,2684,2.01,45,0.66,160,1522.36,9.61,9.14,182,225,31,59,2.285,11.1445896
3015,211,36,239,20,44,11,86,22,2670,2,46,0.64,152,1581.82,13.69,9.15,175,219,33,64,2.2875,17.60301255
2952,207,33,254,18,47,11,85,22,2680,1.69,40,0.62,158,1661,14.42,9.13,174,236,36,63,2.2825,20.18859529
2961,269,45,313,25,59,13,109,28,2626,2.29,50,0.63,196,1523.81,9.77,9.19,224,288,46,81,2.2975,13.21318832
2970,249,40,308,17,57,14,107,27,2655,2.16,49,0.65,201,1590.72,9.7,9.19,209,291,43,80,2.2975,13.6918008
3096,218,36,252,20,39,10,75,20,2417,1.8,39,0.64,162,1544.18,8.99,9.19,182,232,29,55,2.2975,9.917018752
2880,221,35,251,15,49,11,93,25,2606,1.83,43,0.62,157,1613.53,9.2,9.17,186,236,38,68,2.2925,12.57780806
3141,250,42,281,21,46,11,99,26,2560,2.07,50,0.6,169,1624.55,11.3,9.19,208,260,35,73,2.2975,12.82063676
2988,244,39,301,19,58,13,115,29,2472,1.97,46,0.63,190,1728.54,9.18,9.13,205,282,45,86,2.2825,13.45532455
2961,220,36,265,22,44,10,78,20,2494,1.99,45,0.62,165,1668.71,11.22,9.2,184,243,34,58,2.3,13.83681651
2880,226,37,263,21,46,11,90,23,2651,1.93,43,0.59,156,1477.43,9.01,9.22,189,242,35,67,2.305,11.3080446
3006,266,44,291,19,54,12,101,25,2589,2.33,54,0.64,186,1505.98,8.44,9.15,222,272,42,76,2.2875,10.56496102
3105,220,35,262,15,48,12,87,22,2639,1.97,44,0.63,166,1790.48,10.25,9.16,185,247,36,65,2.29,13.78972963
3096,200,33,219,18,43,11,92,24,2661,1.79,43,0.59,130,1574.27,10.34,9.16,167,201,32,68,2.29,13.7079442
3006,218,35,240,24,43,11,82,21,2419,1.88,44,0.63,152,1672.42,10.33,9.23,183,216,32,61,2.3075,12.56393303
3132,218,36,241,13,39,9,75,20,2647,1.8,41,0.6,146,1556.83,12.12,9.22,182,228,30,55,2.305,13.36977389
3069,266,41,315,18,55,13,109,27,2630,2.4,53,0.64,201,1699.13,8.2,9.15,225,297,42,82,2.2875,10.45461958
3015,262,41,322,23,60,13,116,29,2401,2.23,51,0.65,210,1603.58,9.29,9.16,221,299,47,87,2.29,13.11834361
2934,211,34,237,18,43,10,85,21,2605,1.69,38,0.59,141,1635.73,9.45,9.21,177,219,33,64,2.3025,11.87493218
2943,269,44,316,20,54,13,104,27,2417,2.26,52,0.64,201,1594.85,7.85,9.21,225,296,41,77,2.3025,9.716826894
3078,263,43,296,17,50,12,94,23,2492,2.27,53,0.61,180,1681.4,10.49,9.23,220,279,38,71,2.3075,12.29711044
2925,212,35,233,16,45,10,88,22,2686,1.85,42,0.65,151,1558.51,12.83,9.19,177,217,35,66,2.2975,16.79254955
3015,234,36,283,25,52,12,91,24,2452,2,47,0.62,174,1699.8,10.4,9.19,198,258,40,67,2.2975,14.25063297
2916,254,42,286,20,58,14,123,32,2406,2.21,50,0.64,182,1460.3,9.18,9.15,212,266,44,91,2.2875,12.92558736
3051,257,42,307,28,46,11,88,23,2443,2.17,49,0.61,187,1531.17,7.9,9.18,215,279,35,65,2.295,8.718968907
2961,207,34,246,17,43,11,88,22,2538,1.93,44,0.6,148,1541.34,12.45,9.17,173,229,32,66,2.2925,15.94706597
3024,215,35,236,18,44,11,89,22,2473,1.9,43,0.6,142,1578.55,9.7,9.19,180,218,33,67,2.2975,12.24050343
3141,225,37,273,25,39,9,72,19,2609,2.09,47,0.62,168,1577.66,10.02,9.22,188,248,30,53,2.305,10.70935068
3051,209,35,236,16,42,10,90,22,2462,1.76,39,0.64,150,1535.25,11.21,9.2,174,220,32,68,2.3,13.89063009
2979,236,38,279,24,49,12,99,25,2620,2.05,45,0.64,178,1519.69,11.8,9.22,198,255,37,74,2.305,15.1070412
2997,231,38,264,22,43,11,85,21,2406,2.01,47,0.62,164,1503.6,10.34,9.18,193,242,32,64,2.295,11.86834996
3051,211,35,239,16,47,11,97,25,2533,2.02,47,0.6,143,1648.72,10.99,9.19,176,223,36,72,2.2975,15.09476737
2997,260,42,287,21,53,13,105,26,2453,2.16,50,0.62,177,1525,8.47,9.15,218,266,40,79,2.2875,10.64631376
2952,243,39,289,19,47,12,93,24,2598,1.95,45,0.59,171,1484.4,8.15,9.21,204,270,35,69,2.3025,9.719916237
3024,262,40,300,20,58,14,122,30,2570,2.15,51,0.62,186,1728.54,7.56,9.19,222,280,44,92,2.2975,10.31957536
3114,244,39,283,27,52,12,102,26,2505,2.04,47,0.65,183,1709.64,10.69,9.22,205,256,40,76,2.305,14.04767826
3033,202,33,242,17,41,10,79,21,2573,1.94,47,0.63,153,1656.35,11.03,9.23,169,225,31,58,2.3075,13.80452059
3060,211,35,237,21,46,10,94,24,2417,1.79,44,0.63,149,1757.63,10.66,9.19,176,216,36,70,2.2975,14.32999076
3132,204,33,244,17,43,11,76,20,2477,1.71,38,0.62,152,1668.87,9.93,9.14,171,227,32,56,2.285,12.90627355
2925,247,41,296,17,52,13,90,23,2534,1.96,44,0.63,186,1579.32,7.98,9.2,206,279,39,67,2.3,10.35911397
3123,243,38,296,22,50,11,98,25,2469,2.26,53,0.59,175,1730.96,10.81,9.22,205,274,39,73,2.305,13.71521923
3060,243,40,273,25,49,12,91,23,2633,2.25,54,0.61,166,1631.56,8.34,9.23,203,248,37,68,2.3075,10.36977149
2925,240,38,296,18,50,12,103,27,2524,2.18,50,0.62,184,1614.77,8.09,9.13,202,278,38,76,2.2825,10.39251389
2898,227,36,281,20,48,10,96,25,2539,1.92,42,0.64,179,1597.58,9.5,9.14,191,261,38,71,2.285,12.38660575
3051,256,44,298,21,48,11,87,23,2699,2.45,56,0.59,177,1742.15,10.09,9.2,212,277,37,64,2.3,11.66556472
2898,245,40,293,27,54,13,103,27,2519,2.16,49,0.61,178,1611.94,8.85,9.19,205,266,41,76,2.2975,12.02774675
2925,233,37,284,19,51,12,103,26,2605,2.27,54,0.61,173,1556.47,9.03,9.2,196,265,39,77,2.3,12.18751981
2961,211,36,252,16,41,10,73,20,2666,1.69,38,0.59,150,1642.07,11.24,9.17,175,236,31,53,2.2925,13.46731573
3087,202,34,222,15,43,10,74,19,2509,1.66,37,0.64,143,1525.88,10.97,9.22,168,207,33,55,2.305,14.3991562
3105,250,40,308,18,54,12,104,26,2495,2.01,48,0.59,182,1538.81,10.99,9.2,210,290,42,78,2.3,14.63742803
3015,209,33,252,20,41,10,84,22,2424,1.96,47,0.62,156,1593.76,9.77,9.12,176,232,31,62,2.28,11.81804022
3087,263,43,307,25,48,12,93,24,2688,2.48,55,0.61,188,1774.03,8.34,9.14,220,282,36,69,2.285,9.385661105
2979,221,35,269,20,43,11,89,22,2619,2.01,47,0.61,164,1599.64,11.02,9.16,186,249,32,67,2.29,13.22120702
2961,263,43,293,19,55,14,103,26,2608,2.31,53,0.66,192,1619.41,10.42,9.13,220,274,41,77,2.2825,13.4365567
3096,229,38,273,18,41,10,82,21,2635,2.09,46,0.64,175,1722.14,10.29,9.19,191,255,31,61,2.2975,11.35996723
3015,222,36,250,19,52,12,99,26,2578,2.14,48,0.59,148,1686.21,10.68,9.18,186,231,40,73,2.295,15.42534731
3078,238,37,294,23,47,10,94,24,2545,1.93,47,0.61,178,1772.52,9.2,9.17,201,271,37,70,2.2925,11.20268327
3078,269,43,300,21,55,13,106,26,2476,2.21,50,0.6,179,1718.32,9.23,9.16,226,279,42,80,2.29,11.63658215
3051,225,35,263,21,49,11,91,25,2462,1.94,44,0.6,159,1630.83,10.02,9.2,190,242,38,66,2.3,13.45533803
2889,241,41,293,19,47,12,93,24,2514,2.19,49,0.61,179,1576.67,10.88,9.19,200,274,35,69,2.2975,13.08347292
3132,221,37,261,21,47,11,92,24,2680,2.16,49,0.62,162,1787.7,12.96,9.17,184,240,36,68,2.2925,16.99510746
2979,264,42,325,23,55,12,113,29,2495,2.15,49,0.65,210,1564.38,7.36,9.18,222,302,43,84,2.295,9.454746874
3033,236,37,283,16,51,12,99,25,2665,1.96,47,0.6,170,1692.75,11.63,9.16,199,267,39,74,2.29,15.49712789
3069,225,37,252,22,44,10,88,22,2454,2,46,0.63,160,1542.61,10.88,9.21,188,230,34,66,2.3025,13.11935195
2916,245,39,274,23,48,12,104,27,2698,2.4,55,0.65,178,1668.84,8.73,9.14,206,251,36,77,2.285,10.54636326
2970,234,40,276,21,47,12,97,24,2531,2.1,50,0.61,167,1491.78,11.87,9.22,194,255,35,73,2.305,14.70097194
2916,257,40,299,28,55,14,112,28,2414,2.49,57,0.61,183,1529.05,8.08,9.15,217,271,41,84,2.2875,10.66238245
2988,203,32,249,16,39,10,77,20,2614,1.85,43,0.6,148,1718.56,9.69,9.14,171,233,29,57,2.285,11.47904281
3051,214,34,241,19,41,11,79,20,2552,1.86,44,0.64,154,1585.06,10.37,9.19,180,222,30,59,2.2975,12.25073566
2880,252,41,308,22,46,12,98,25,2547,2.37,56,0.65,200,1526.4,11.5,9.19,211,286,34,73,2.2975,12.9439987
2970,241,40,278,21,54,13,101,25,2498,2.01,47,0.64,177,1625.84,7.91,9.16,201,257,41,76,2.29,10.92865031
3024,209,34,244,17,39,9,71,19,2607,1.89,45,0.64,157,1686.04,10.45,9.12,175,227,30,52,2.28,12.02397157
2907,244,41,275,22,44,11,88,22,2499,2.14,47,0.65,179,1440.46,11,9.2,203,253,33,66,2.3,12.23119428
2916,254,41,294,26,51,12,97,24,2481,2.4,53,0.66,193,1686.4,7.75,9.13,213,268,39,73,2.2825,9.595143877
3123,219,36,270,23,51,13,106,27,2533,1.95,45,0.63,170,1598.77,9.41,9.19,183,247,38,79,2.2975,13.51229176
3141,207,33,232,16,44,10,80,20,2415,1.98,46,0.61,141,1620.57,9.75,9.21,174,216,34,60,2.3025,12.77910022
2997,206,34,237,15,46,11,83,22,2457,1.89,44,0.64,151,1621.53,12.27,9.14,172,222,35,61,2.285,16.89462293
3078,211,35,233,17,48,11,98,25,2467,2.07,48,0.65,151,1677.57,10.07,9.2,176,216,37,73,2.3,14.1254269
3024,214,36,260,21,48,11,88,23,2484,1.94,45,0.6,156,1604.56,9.22,9.14,178,239,37,65,2.285,12.75180651
2970,242,40,300,22,50,12,93,25,2463,2.16,49,0.61,184,1593.02,11.11,9.13,202,278,38,68,2.2825,14.1540924
2925,232,38,263,22,55,12,114,28,2599,1.86,43,0.65,171,1504.9,11.55,9.19,194,241,43,86,2.2975,16.88379297
3015,239,37,266,23,51,13,99,26,2455,2.06,48,0.6,160,1544.27,10.99,9.23,202,243,38,73,2.3075,14.46049957
3042,248,41,298,23,50,13,92,25,2563,2.28,54,0.6,179,1570.31,8.55,9.16,207,275,37,67,2.29,10.62913119
2916,239,37,287,16,45,11,82,21,2635,1.92,44,0.63,180,1522.6,12.47,9.24,202,271,34,61,2.31,14.4775274
3033,247,41,288,19,59,13,114,29,2690,2.01,46,0.62,180,1561.53,9.81,9.14,206,269,46,85,2.285,14.44898682
3123,264,44,320,22,53,13,106,28,2481,2.14,50,0.64,204,1763.51,7.74,9.22,220,298,40,78,2.305,9.581339581
3015,258,42,317,25,52,13,107,28,2400,2.2,49,0.62,197,1603.51,9.7,9.16,216,292,39,79,2.29,12.05504126
3006,218,35,267,22,46,12,95,25,2553,1.93,45,0.6,162,1616.08,9.97,9.2,183,245,34,70,2.3,12.97208619
3042,235,38,275,21,50,12,90,24,2642,2.14,51,0.61,168,1653.35,11.41,9.23,197,254,38,66,2.3075,14.96928703
3087,256,40,282,20,47,11,98,26,2443,2.47,56,0.65,185,1768.93,9.37,9.21,216,262,36,72,2.3025,10.60744559
2970,205,32,231,15,49,11,98,26,2562,1.84,42,0.65,151,1582.42,9.53,9.23,173,216,38,72,2.3075,14.04586367
3096,227,38,267,22,41,10,83,22,2494,2.02,47,0.64,171,1726.4,9.11,9.17,189,245,31,61,2.2925,10.14587963
2880,206,32,228,16,36,9,78,20,2627,1.97,46,0.66,149,1449.34,13.25,9.2,174,212,27,58,2.3,14.277905
3087,256,43,284,23,57,14,114,30,2642,2.45,56,0.6,171,1694.82,8.68,9.18,213,261,43,84,2.295,11.91702759
3051,251,41,295,20,58,14,108,28,2526,2.46,57,0.65,191,1553.16,9.47,9.19,210,275,44,80,2.2975,13.49328149
3078,244,40,277,17,48,12,96,25,2631,2.35,56,0.59,164,1537.02,10.15,9.18,204,260,36,71,2.295,12.31206168
2979,228,37,264,16,51,12,106,27,2400,2.16,51,0.6,158,1507.96,10.13,9.15,191,248,39,79,2.2875,13.97198477
3087,239,38,275,22,46,11,84,22,2506,1.93,46,0.62,170,1561.54,9.92,9.16,201,253,35,62,2.29,11.77294004
2952,245,42,280,27,50,12,98,26,2414,2.28,51,0.64,179,1595.68,8.56,9.23,203,253,38,72,2.3075,10.77186778
3123,212,34,259,17,41,10,91,23,2695,1.88,43,0.62,162,1774.77,10.86,9.12,178,242,31,68,2.28,12.95063759
2988,204,33,234,15,43,10,84,21,2546,1.85,40,0.65,153,1655.13,10.02,9.18,171,219,33,63,2.295,13.02324884
2916,256,44,294,24,59,14,114,29,2414,2.15,50,0.65,190,1628.45,10.83,9.15,212,270,45,85,2.2875,15.39053909
3078,204,34,252,20,46,11,97,25,2477,1.64,40,0.64,160,1601.33,13.03,9.23,170,232,35,72,2.3075,18.11696349
2943,200,32,219,19,43,10,75,18,2427,1.79,40,0.6,131,1514.41,9.42,9.19,168,200,33,57,2.2975,12.48828185
3042,264,42,318,22,47,12,89,23,2630,2.27,53,0.61,194,1625.89,8.05,9.2,222,296,35,66,2.3,8.836965118
2970,243,39,282,24,56,12,104,27,2593,2,43,0.62,174,1608.66,11.99,9.13,204,258,44,77,2.2825,17.03782942
3042,210,35,248,16,50,12,88,23,2612,1.78,41,0.63,157,1729.65,11.22,9.16,175,232,38,65,2.29,16.47240061
3033,231,39,269,20,49,12,97,24,2461,2.01,48,0.64,173,1692.17,9.25,9.2,192,249,37,73,2.3,12.09871265
2979,264,43,298,17,48,11,86,22,2473,2.53,58,0.6,180,1644.43,7.37,9.17,221,281,37,64,2.2925,8.262626616
3051,223,38,255,19,45,11,79,21,2640,2.16,50,0.61,157,1756.64,12.62,9.17,185,236,34,58,2.2925,15.70291699
2880,254,42,289,22,52,12,100,26,2479,2.39,56,0.62,180,1475.99,9.37,9.13,212,267,40,74,2.2825,11.82830589
2961,212,37,259,20,38,10,72,19,2496,2.05,47,0.65,167,1520.03,13.09,9.16,175,239,28,53,2.29,14.46774053
2907,252,42,306,21,54,13,105,27,2491,2.09,47,0.66,202,1531.87,11.19,9.15,210,285,41,78,2.2875,14.78552108
2907,269,44,331,28,51,13,103,27,2513,2.21,52,0.6,198,1640.9,9.31,9.23,225,303,38,76,2.3075,10.88380886
3024,218,37,246,22,43,10,84,21,2514,1.74,39,0.6,147,1662.15,10.48,9.12,181,224,33,63,2.28,12.74637155
2979,260,42,303,21,50,12,92,22,2658,2.22,54,0.63,189,1613.63,9.85,9.13,218,282,38,70,2.2825,11.68009072
3069,216,35,240,19,45,11,84,23,2628,1.78,40,0.65,156,1693.21,10.65,9.13,181,221,34,61,2.2825,13.6811215
3105,216,35,236,21,43,10,88,23,2620,1.82,44,0.65,154,1748.14,11.14,9.12,181,215,33,65,2.28,13.6745557
3042,227,38,256,17,46,11,98,25,2627,2.16,48,0.64,163,1568.26,8.86,9.12,189,239,35,73,2.28,11.07080052
3114,233,38,266,21,54,13,103,25,2493,2.03,45,0.62,166,1547.12,8.45,9.18,195,245,41,78,2.295,12.0755766
2961,220,37,255,16,46,11,89,23,2419,1.8,40,0.6,153,1614.66,8.42,9.2,183,239,35,66,2.3,10.85576846
2988,233,37,266,19,51,13,92,23,2480,2.03,46,0.65,173,1483.37,10.26,9.18,196,247,38,69,2.295,13.84761387
2970,242,39,287,21,51,12,105,27,2656,1.95,45,0.61,176,1651.96,9.73,9.23,203,266,39,78,2.3075,12.64389788
3060,234,38,279,23,47,12,95,24,2592,2.12,51,0.63,177,1520.14,9.46,9.23,196,256,35,71,2.3075,11.71619162
3024,251,41,287,22,48,11,97,24,2463,2.31,54,0.64,183,1610.36,9.6,9.15,210,265,37,73,2.2875,11.3201473
2934,214,34,254,21,45,10,81,22,2620,1.72,42,0.65,165,1600.3,12.08,9.15,180,233,35,59,2.2875,15.66314628
2961,264,43,299,24,50,12,94,24,2469,2.35,55,0.63,188,1539.57,7.5,9.14,221,275,38,70,2.285,8.758720547
3123,235,39,262,25,43,11,91,24,2485,2.3,53,0.59,155,1801.13,10.53,9.15,196,237,32,67,2.2875,11.88070723
3132,260,43,319,25,50,12,94,25,2608,2.22,51,0.63,200,1615.11,7.97,9.12,217,294,38,69,2.28,9.45079422
3141,211,35,230,19,39,10,80,21,2557,1.76,40,0.65,151,1727.18,10.17,9.16,176,211,29,59,2.29,11.59088065
2979,261,42,289,22,55,13,103,26,2591,2.25,50,0.61,177,1496.23,9.49,9.17,219,267,42,77,2.2925,12.33109728
2916,245,40,295,23,44,10,88,22,2634,1.98,47,0.65,192,1586.77,10.81,9.13,205,272,34,66,2.2825,11.97086727
2898,211,34,234,16,40,9,83,21,2687,2.06,49,0.64,151,1462.55,12.81,9.13,177,218,31,62,2.2825,14.97407469
3069,262,42,298,23,52,13,100,26,2513,2.47,55,0.6,180,1638.76,9.88,9.17,220,275,39,74,2.2925,12.09128133
2880,214,35,259,23,50,12,98,26,2548,1.79,43,0.6,156,1596.26,10.63,9.18,179,236,38,72,2.295,15.31450009
3024,242,41,280,22,52,12,98,26,2499,2.33,54,0.61,172,1572.78,11.32,9.14,201,258,40,72,2.285,14.99849677
3006,251,41,284,23,58,14,110,29,2539,2.19,49,0.66,187,1716.87,8.59,9.16,210,261,44,81,2.29,12.23941795
3105,205,34,244,16,40,9,77,19,2455,1.8,42,0.64,156,1642.02,10.82,9.17,171,228,31,58,2.2925,13.01807353
2997,213,34,263,21,42,9,81,21,2458,1.83,41,0.64,169,1527.06,8.91,9.23,179,242,33,60,2.3075,10.83329876
2889,260,42,323,19,57,14,110,28,2416,2.14,51,0.63,204,1640.17,7.36,9.21,218,304,43,82,2.3025,9.949302864
2889,237,39,289,25,44,11,84,21,2594,2.3,55,0.65,187,1463.39,8.71,9.19,198,264,33,63,2.2975,9.970933384
3087,225,36,274,24,51,12,101,26,2508,2.08,48,0.62,169,1674.76,8.99,9.16,189,250,39,75,2.29,12.56494752
2907,211,34,240,22,45,11,84,23,2634,1.73,41,0.65,157,1596.37,12.78,9.18,177,218,34,61,2.295,16.80638242
3033,226,39,262,19,45,11,89,23,2589,2.08,47,0.62,163,1549.81,11.16,9.2,187,243,34,66,2.3,13.70192539
2961,216,35,255,16,48,12,91,23,2496,1.75,40,0.63,161,1574.39,9.21,9.16,181,239,36,68,2.29,12.6200317
3096,256,42,300,19,50,12,101,26,2509,2.3,52,0.65,195,1707.62,9,9.22,214,281,38,75,2.305,10.83891668
3051,266,44,321,28,49,11,98,25,2454,2.48,58,0.6,191,1739.28,7.96,9.13,222,293,38,73,2.2825,9.041507365
2907,264,44,304,25,56,13,108,27,2425,2.47,57,0.61,185,1465.13,9.08,9.19,220,279,43,81,2.2975,11.87635793
3105,265,44,318,30,55,13,101,25,2574,2.51,58,0.65,206,1593.45,10.8,9.21,221,288,42,76,2.3025,13.82145933
3033,206,33,232,19,41,10,85,23,2406,1.68,40,0.6,138,1593.15,10.43,9.23,173,213,31,62,2.3075,12.80012686
3105,224,36,264,19,50,13,93,24,2543,1.92,45,0.65,171,1674.61,10.54,9.12,188,245,37,69,2.28,14.50694372
3033,209,35,254,15,42,10,73,19,2470,1.83,42,0.6,152,1643.34,12.03,9.12,174,239,32,54,2.28,14.90671543
2988,269,44,301,23,53,13,103,25,2656,2.5,58,0.6,181,1542.01,8.11,9.16,225,278,40,78,2.29,9.852757028
3105,212,34,232,17,45,11,79,21,2417,1.91,42,0.63,147,1686.67,9.44,9.19,178,215,34,58,2.2975,12.35554698
2925,269,44,333,26,58,13,121,30,2413,2.57,58,0.66,219,1535.12,8.23,9.24,225,307,45,91,2.31,10.94180267
2988,235,39,276,18,48,11,99,26,2545,2,44,0.59,164,1647.84,10.98,9.14,196,258,37,73,2.285,13.82894484
3015,206,35,250,21,41,10,87,23,2632,1.76,42,0.64,161,1734.34,12.79,9.14,171,229,31,64,2.285,15.69641636
3114,239,40,286,20,45,11,78,20,2531,2.27,54,0.64,182,1732.3,9.69,9.19,199,266,34,58,2.2975,11.24997919
3078,211,34,243,21,43,10,90,23,2426,1.99,46,0.62,152,1613.36,9.56,9.2,177,222,33,67,2.3,12.01315891
3033,224,37,268,21,44,10,88,23,2450,1.9,43,0.66,177,1571.54,9.04,9.12,187,247,34,65,2.28,10.94930158
2889,219,35,245,22,47,11,81,21,2496,1.86,44,0.63,155,1471.16,12.48,9.14,184,223,36,60,2.285,16.51511711
3078,258,42,292,17,54,13,104,26,2521,2.51,58,0.61,179,1755.79,8.96,9.21,216,275,41,78,2.3025,11.5636621
2952,259,42,284,20,51,11,101,26,2486,2.49,55,0.6,171,1651.1,9.22,9.14,217,264,40,75,2.285,11.19475678
2880,231,37,263,22,47,12,96,25,2480,2.23,52,0.59,155,1536.55,9.26,9.13,194,241,35,71,2.2825,11.61743347
3042,269,44,329,28,60,14,109,28,2667,2.34,52,0.59,195,1709.41,8.96,9.18,225,301,46,81,2.295,12.32310955
2925,212,36,247,21,45,12,93,24,2410,1.75,40,0.63,156,1491.8,8.79,9.13,176,226,33,69,2.2825,11.50479428
2997,247,39,277,22,55,13,112,29,2626,2.44,59,0.62,171,1515.39,11.84,9.21,208,255,42,83,2.3025,16.25663923
3141,234,38,262,19,43,10,89,22,2617,2.29,51,0.62,161,1661.42,12.66,9.21,196,243,33,67,2.3025,14.34496963
2961,259,42,313,23,47,12,86,23,2490,2.27,51,0.62,194,1625.83,10.39,9.22,217,290,35,63,2.305,11.62591038
2943,251,41,300,19,50,12,100,25,2452,2.13,50,0.61,182,1568.72,9.02,9.14,210,281,38,75,2.285,11.07939764
3042,264,43,292,21,53,12,98,26,2689,2.3,52,0.62,180,1582.27,9.81,9.23,221,271,41,72,2.3075,12.14379086
3069,246,40,279,18,47,12,92,25,2639,2.2,49,0.64,179,1566.46,9.54,9.17,206,261,35,67,2.2925,11.23891676
3114,232,37,255,24,49,11,88,23,2416,1.9,43,0.63,160,1732.69,9.06,9.14,195,231,38,65,2.285,11.79912011
2970,209,35,230,21,42,10,76,19,2697,1.89,45,0.65,150,1483.69,11.15,9.13,174,209,32,57,2.2825,13.81628238
3024,221,37,263,23,47,11,87,22,2668,1.87,41,0.64,168,1546.97,9.94,9.15,184,240,36,65,2.2875,13.03482779
3033,204,34,240,19,43,10,76,20,2515,1.96,43,0.64,153,1609.24,13.69,9.18,170,221,33,56,2.295,17.79324118
2997,247,40,291,22,52,12,108,29,2568,2.4,58,0.61,178,1685.09,9.75,9.22,207,269,40,79,2.305,12.65681218
2943,257,42,288,17,50,12,101,25,2681,2.06,49,0.59,171,1518.15,10.48,9.21,215,271,38,76,2.3025,12.57220613
3042,251,41,280,17,58,13,110,29,2513,2.11,49,0.64,180,1516.4,7.97,9.15,210,263,45,81,2.2875,11.35601409
2988,251,41,287,20,47,11,93,24,2512,2.39,55,0.6,172,1600,10.42,9.23,210,267,36,69,2.3075,12.03109579
2961,232,37,266,22,45,11,89,22,2604,2.08,48,0.63,166,1560.45,10.03,9.2,195,244,34,67,2.3,11.99606447
2979,260,42,294,21,54,12,109,28,2619,2.45,58,0.63,186,1492.49,10.95,9.2,218,273,42,81,2.3,14.02322364
3033,238,39,262,18,51,12,108,27,2594,2.02,48,0.63,166,1682.04,9.96,9.22,199,244,39,81,2.305,13.16030295
2970,238,39,283,20,53,13,101,26,2628,2.09,49,0.66,186,1520.7,10.78,9.23,199,263,40,75,2.3075,14.80236138
2979,243,40,299,18,48,11,103,26,2527,2.1,47,0.64,193,1633.85,8.62,9.23,203,281,37,77,2.3075,10.49918429
3132,214,34,257,18,49,12,98,25,2474,1.77,41,0.61,157,1654.44,11.03,9.13,180,239,37,73,2.2825,15.57295929
3087,247,40,287,16,47,11,93,24,2540,2.13,49,0.61,174,1670.76,11.52,9.13,207,271,36,69,2.2825,13.5165767
3033,257,41,298,19,53,13,102,27,2435,2.32,52,0.6,178,1587.48,7.39,9.12,216,279,40,75,2.28,9.397244226
3042,236,39,292,24,51,11,94,24,2544,1.94,44,0.6,175,1574.25,10.13,9.14,197,268,40,70,2.285,13.49835817
2988,256,41,284,20,52,13,111,28,2669,2.24,54,0.61,174,1712.85,7.91,9.13,215,264,39,83,2.2825,9.907251573
2925,229,38,259,19,45,10,86,22,2566,2.12,47,0.64,166,1506.9,12.04,9.18,191,240,35,64,2.295,14.58870853
2898,215,36,267,17,45,10,82,22,2442,1.75,42,0.63,170,1475.92,10.3,9.14,179,250,35,60,2.285,13.29304907
2997,204,32,248,17,42,10,83,21,2588,1.9,43,0.6,149,1552.57,10.64,9.13,172,231,32,62,2.2825,13.50747213
3069,240,38,272,19,49,11,99,26,2591,2.23,51,0.64,174,1588.56,11.71,9.18,202,253,38,73,2.295,14.74195437
2898,221,38,253,17,41,9,85,22,2559,1.76,42,0.64,162,1574.72,11.88,9.14,183,236,32,63,2.285,13.59005934
3033,243,38,279,21,51,12,92,24,2555,2.23,49,0.65,180,1559.63,9.25,9.19,205,258,39,68,2.2975,11.97068394
2952,222,35,256,21,51,11,97,25,2571,2.05,48,0.61,155,1631.25,12.55,9.16,187,235,40,72,2.29,17.77764611
2934,254,41,291,24,50,12,91,24,2456,2.14,49,0.63,183,1503.98,8.61,9.18,213,267,38,67,2.295,10.45087777
3114,221,37,268,21,44,12,79,20,2424,1.92,44,0.59,158,1720.51,9.5,9.12,184,247,32,59,2.28,11.66265255
3096,259,43,293,21,53,13,102,26,2682,2.5,55,0.61,180,1602.73,11.64,9.18,216,272,40,76,2.295,14.6873152
2970,248,40,280,25,52,12,100,25,2526,2.37,53,0.65,182,1587.03,7.93,9.16,208,255,40,75,2.29,10.25269834
3024,252,39,310,21,57,13,116,30,2461,2.18,49,0.59,184,1637.56,10.76,9.22,213,289,44,86,2.305,15.00720847
2943,236,39,268,21,54,13,93,23,2700,1.92,43,0.61,162,1522.01,10.26,9.19,197,247,41,70,2.2975,14.47579576
3042,200,32,242,15,40,9,72,20,2665,1.66,37,0.6,145,1514.51,14.54,9.16,168,227,31,52,2.29,17.93113298
3105,224,37,270,25,51,12,96,24,2530,1.8,40,0.62,167,1759.56,10.32,9.19,187,245,39,72,2.2975,14.48822508
2880,217,34,267,22,45,11,93,24,2460,1.77,41,0.59,158,1631.75,10.48,9.19,183,245,34,69,2.2975,13.40069713
2907,259,43,297,28,49,11,98,25,2439,2.36,55,0.65,194,1467.2,10.31,9.13,216,269,38,73,2.2825,12.02730462
2898,266,41,327,22,49,12,101,25,2652,2.17,49,0.62,204,1589.9,9.25,9.14,225,305,37,76,2.285,10.50677677
2916,265,43,327,22,59,15,104,27,2631,2.44,57,0.65,214,1521.07,9.44,9.2,222,305,44,77,2.3,12.95959594
3069,221,36,249,22,43,10,88,23,2560,1.88,43,0.6,150,1550.68,9.21,9.21,185,227,33,65,2.3025,11.04966576
3078,249,41,280,16,52,13,94,24,2505,2.14,48,0.62,175,1695.81,9.63,9.19,208,264,39,70,2.2975,12.4006261
3060,244,39,284,19,47,11,99,26,2492,2.32,55,0.64,181,1530.01,10.21,9.21,205,265,36,73,2.3025,12.12682479
3024,268,42,303,28,58,13,101,25,2602,2.64,59,0.66,199,1749.75,7.69,9.12,226,275,45,76,2.28,10.26202028
2952,235,38,267,23,49,12,92,23,2411,2.02,48,0.64,169,1519.23,8.58,9.14,197,244,37,69,2.285,11.03135434
3096,258,40,286,21,51,12,99,25,2663,2.25,54,0.63,180,1647.31,11.04,9.16,218,265,39,74,2.29,13.45652346
2925,223,36,271,20,46,11,89,22,2524,2.09,47,0.64,173,1470.57,10.01,9.16,187,251,35,67,2.29,12.7321098
3141,257,42,310,25,59,14,104,26,2594,2.24,49,0.64,198,1681.98,10.97,9.14,215,285,45,78,2.285,15.52883392
2970,258,43,309,28,56,13,113,29,2645,2.31,52,0.6,184,1544.27,8.99,9.14,215,281,43,84,2.285,12.03209749
2889,245,40,301,17,47,11,82,21,2435,1.95,44,0.63,188,1544.93,8.42,9.15,205,284,36,61,2.2875,9.959950828
3015,218,37,240,16,44,11,95,25,2507,1.91,43,0.6,144,1611.37,10.02,9.16,181,224,33,70,2.29,12.47030954
2898,244,39,270,25,52,12,98,25,2697,2.11,48,0.65,177,1475.69,10.96,9.19,205,245,40,73,2.2975,14.40248398
2907,268,42,295,20,58,13,103,27,2437,2.6,60,0.59,175,1657.2,8.47,9.18,226,275,45,76,2.295,11.3029014
3042,220,36,257,18,40,9,83,22,2490,1.76,38,0.6,156,1647.9,12.23,9.17,184,239,31,61,2.2925,13.71125149
2961,232,39,282,19,49,11,86,22,2598,1.89,45,0.65,184,1694.03,12.33,9.19,193,263,38,64,2.2975,16.05774293
3087,252,41,311,26,52,12,96,24,2556,2.28,51,0.62,192,1567.93,9.49,9.21,211,285,40,72,2.3025,12.07486669
3132,208,33,252,17,44,10,84,22,2686,1.77,40,0.63,159,1789.39,9.98,9.2,175,235,34,62,2.3,13.01766863
3078,219,37,253,18,45,11,92,24,2646,1.82,41,0.64,163,1765.13,13.58,9.12,182,235,34,68,2.28,17.20606258
3051,267,43,313,19,54,13,97,25,2498,2.38,54,0.62,195,1595.04,8.19,9.18,224,294,41,72,2.295,10.21362079
2898,233,38,259,23,44,11,89,22,2677,2.09,48,0.62,161,1528.04,10.24,9.24,195,236,33,67,2.31,11.92367256
3069,219,36,247,24,49,11,93,25,2549,1.95,44,0.66,162,1632.54,12.38,9.2,183,223,38,68,2.3,17.07992421
3051,221,37,265,20,43,11,82,21,2627,2.03,49,0.65,173,1652.6,10.55,9.22,184,245,32,61,2.305,12.65732614
2898,207,35,249,15,40,10,79,19,2515,2,47,0.63,158,1521.45,11.29,9.14,172,234,30,60,2.285,13.45231156
3105,264,43,303,26,53,13,99,26,2691,2.46,57,0.64,195,1754.11,8.49,9.13,221,277,40,73,2.2825,10.50976396
2997,201,32,222,15,44,10,88,23,2417,1.76,40,0.63,140,1528.97,9.19,9.13,169,207,34,65,2.2825,12.40467698
2988,215,35,239,17,49,12,86,23,2411,1.87,43,0.65,155,1583.04,11.25,9.15,180,222,37,63,2.2875,15.80969428
3123,245,40,279,23,54,12,109,28,2554,2.01,45,0.64,177,1596.77,8.49,9.2,205,256,42,81,2.3,11.53848248
3096,267,43,317,22,57,13,104,27,2621,2.56,60,0.6,191,1766.89,10.12,9.17,224,295,44,77,2.2925,13.32163211
3060,254,42,295,23,54,13,106,27,2524,2.14,50,0.66,193,1631.84,8.75,9.18,212,272,41,79,2.295,11.4704756
2907,241,41,263,21,49,11,85,22,2521,1.96,44,0.61,160,1666.85,9.19,9.17,200,242,38,63,2.2925,11.5214696
2970,202,35,236,16,44,11,80,21,2481,1.6,36,0.62,147,1713.63,9.85,9.15,167,220,33,59,2.2875,13.22972652
3006,249,41,285,22,48,12,93,24,2587,2.32,52,0.6,170,1518.03,11.81,9.22,208,263,36,69,2.305,14.03799609
3051,269,45,317,29,55,12,106,28,2528,2.51,59,0.61,194,1555.22,7.5,9.23,224,288,43,78,2.3075,9.455510955
3105,241,41,290,19,46,10,86,22,2574,2.07,47,0.64,185,1794.97,11.06,9.13,200,271,36,64,2.2825,13.01695026
3069,209,35,236,19,44,11,80,21,2491,1.73,38,0.63,149,1732.35,10.89,9.23,174,217,33,59,2.3075,14.1366856
2889,204,33,224,20,38,10,82,21,2556,1.65,38,0.6,134,1545.74,14.04,9.24,171,204,28,61,2.31,16.12626775
3051,220,38,265,17,48,12,95,23,2682,1.85,42,0.61,161,1732,9.86,9.22,182,248,36,72,2.305,13.26504723
3015,258,42,285,25,50,11,99,25,2575,2.37,54,0.62,178,1668.27,8.57,9.19,216,260,39,74,2.2975,10.24104913
2997,262,43,315,22,56,14,112,29,2550,2.58,60,0.61,192,1568.08,10.1,9.22,219,293,42,83,2.305,13.31132965
3024,228,36,251,17,49,11,90,23,2621,2.23,50,0.62,154,1732.15,11.97,9.22,192,234,38,67,2.305,15.86239326
3015,209,35,243,15,42,10,84,22,2416,1.92,45,0.63,154,1685.36,9.03,9.23,174,228,32,62,2.3075,11.18933004
3024,259,43,289,25,58,14,106,28,2448,2.46,56,0.6,172,1653.42,10.49,9.22,216,264,44,78,2.305,14.48495155
3051,251,40,289,23,59,14,120,30,2681,2.3,55,0.66,190,1604.91,10.27,9.22,211,266,45,90,2.305,14.88545325
2880,240,39,285,21,50,11,98,25,2508,2.07,49,0.62,176,1436.02,10.98,9.24,201,264,39,73,2.31,14.10504357
3141,251,41,281,24,50,11,99,25,2421,2.26,53,0.64,179,1700.36,7.49,9.22,210,257,39,74,2.305,9.200076314
3087,266,44,303,22,55,13,105,27,2657,2.51,56,0.62,186,1610.15,8.33,9.2,222,281,42,78,2.3,10.62036355
3051,259,41,309,21,46,11,85,22,2550,2.19,50,0.61,187,1753.13,8.46,9.15,218,288,35,63,2.2875,9.26492184
3069,216,35,266,24,49,12,92,23,2529,1.9,43,0.63,169,1560.58,11,9.2,181,242,37,69,2.3,15.38680122
2997,216,34,266,16,42,11,72,19,2522,2.09,50,0.61,163,1675.08,9.3,9.23,182,250,31,53,2.3075,11.15043517
3078,265,45,313,23,49,12,98,25,2413,2.46,59,0.64,202,1623.44,8.08,9.19,220,290,37,73,2.2975,9.212444747
3132,209,35,234,19,49,12,94,24,2450,1.94,44,0.61,143,1589.46,10.85,9.22,174,215,37,70,2.305,15.68530115
2934,241,39,292,22,49,11,96,25,2650,2.19,52,0.64,186,1533.02,9.01,9.14,202,270,38,71,2.285,11.29580425
3024,262,43,296,25,48,11,93,24,2687,2.44,56,0.62,183,1699.1,11.69,9.18,219,271,37,69,2.295,13.20589338
3132,242,39,280,21,56,14,109,28,2692,2.03,49,0.6,168,1770.92,11.69,9.21,203,259,42,81,2.3025,16.68017111
2952,238,40,287,21,53,12,92,23,2694,2.18,51,0.64,184,1605.43,10.78,9.22,198,266,41,69,2.305,14.80236138
3042,218,36,255,15,44,12,87,22,2631,2.01,48,0.62,159,1560.23,11.4,9.12,182,240,32,65,2.28,14.18777732
3042,265,43,310,27,51,12,99,25,2595,2.23,50,0.64,198,1637.9,9.75,9.18,222,283,39,74,2.295,11.57023679
3024,222,36,245,17,42,10,80,21,2499,2.05,47,0.65,160,1550.91,12.9,9.22,186,228,32,59,2.305,15.04871286
2979,205,33,248,16,44,10,84,21,2545,1.77,43,0.65,160,1525.43,12.01,9.23,172,232,34,63,2.3075,15.89480309
2979,260,44,289,25,53,13,98,26,2650,2.47,59,0.64,185,1517.74,8.9,9.18,216,264,40,72,2.295,11.18679958
2979,261,42,323,23,55,13,107,28,2425,2.2,51,0.62,199,1572.19,9.35,9.18,219,300,42,79,2.295,12.14918436
3087,213,33,235,14,39,10,73,19,2669,1.76,41,0.62,146,1713.23,11.65,9.17,180,221,29,54,2.2925,13.15298298
2880,214,36,264,22,43,11,77,20,2481,1.71,40,0.66,174,1445.66,9.5,9.18,178,242,32,57,2.295,11.7704107
3132,263,43,300,24,51,12,93,23,2481,2.58,58,0.6,181,1759.19,9.15,9.14,220,276,39,70,2.285,10.94079425
3042,240,39,267,22,54,13,109,28,2534,2.14,48,0.62,166,1670.13,9.14,9.14,201,245,41,81,2.285,12.6806654
3006,232,37,266,23,51,12,102,25,2598,2.17,49,0.65,172,1514.08,10.92,9.2,195,243,39,77,2.3,14.80192362
3132,247,41,289,24,53,12,100,25,2579,2.16,49,0.63,181,1687.36,9.17,9.18,206,265,41,75,2.295,12.13281516
3015,206,33,243,15,44,11,90,23,2697,1.68,39,0.62,150,1682.46,10.59,9.16,173,228,33,67,2.29,13.94744783
2952,251,39,285,27,52,12,109,28,2616,2.11,50,0.61,174,1478.65,8.08,9.2,212,258,40,81,2.3,10.3217732
2988,248,40,283,21,47,11,95,25,2497,2.38,53,0.59,168,1592.31,9.59,9.23,208,262,36,70,2.3075,11.20670948
3078,266,43,330,22,55,13,104,27,2674,2.28,53,0.6,197,1605.31,8.62,9.2,223,308,42,77,2.3,10.9901001
2925,213,34,250,19,41,9,84,21,2477,1.71,40,0.64,159,1631.39,9.26,9.16,179,231,32,63,2.29,10.99078138
2988,223,37,245,17,54,14,96,25,2657,1.92,44,0.61,150,1673.59,9.83,9.13,186,228,40,71,2.2825,14.67762352
2997,245,41,284,23,44,11,86,22,2686,2.38,53,0.63,179,1648.68,10.78,9.16,204,261,33,64,2.29,11.93764562
2907,218,35,249,22,42,10,83,21,2595,1.8,43,0.65,163,1446.21,9.8,9.17,183,227,32,62,2.2925,11.64212349
2952,245,40,281,24,50,12,87,22,2458,1.99,46,0.65,184,1532.59,8.08,9.2,205,257,38,65,2.3,10.16783781
2934,201,34,235,20,49,12,92,23,2608,1.88,44,0.6,140,1501.75,12.73,9.24,167,215,37,69,2.31,19.13558552
3024,222,38,248,18,50,11,98,25,2576,1.91,43,0.65,161,1717.8,11.66,9.12,184,230,39,73,2.28,16.19305942
2898,212,35,254,17,42,11,84,22,2537,1.77,40,0.65,165,1592.58,12.05,9.21,177,237,31,62,2.3025,14.72020322
3096,228,37,279,21,51,12,94,24,2681,1.82,40,0.61,170,1715.71,10.18,9.22,191,258,39,70,2.305,14.04094817
3069,263,41,312,28,59,13,124,32,2451,2.17,48,0.59,184,1755.52,7.76,9.15,222,284,46,92,2.2875,10.73424031
3105,244,39,274,23,52,11,93,24,2644,2.17,49,0.63,172,1741.19,10.45,9.2,205,251,41,69,2.3,13.7322954
2952,230,38,262,22,44,11,85,22,2448,1.91,43,0.61,161,1689.72,10.47,9.14,192,240,33,63,2.285,12.35050886
2943,210,36,247,21,45,11,89,23,2458,1.83,43,0.64,159,1647.23,12.18,9.18,174,226,34,66,2.295,16.09362348
3069,214,35,242,17,44,10,85,21,2518,1.99,44,0.59,144,1756.31,12.72,9.23,179,225,34,64,2.3075,16.12647114
2970,265,43,299,18,62,14,115,29,2655,2.26,51,0.62,186,1518.84,9.4,9.2,222,281,48,86,2.3,13.56085269
2889,214,35,248,17,47,12,88,23,2573,2.03,47,0.6,149,1585.37,10.9,9.23,179,231,35,65,2.3075,14.76127638
2952,265,43,292,21,52,13,103,26,2453,2.27,51,0.65,190,1643.34,9.79,9.14,222,271,39,77,2.285,11.84550256
2916,255,42,281,19,58,14,116,29,2494,2.14,49,0.61,172,1541.92,7.58,9.21,213,262,44,87,2.3025,10.63090771
2880,234,38,259,21,46,11,102,27,2617,2.09,46,0.65,169,1592.9,11.18,9.15,196,238,35,75,2.2875,13.55180385
3024,230,39,282,16,42,10,79,21,2424,2.02,47,0.66,185,1532.99,10.35,9.14,191,266,32,58,2.285,11.65400321
2997,236,37,290,20,49,11,98,25,2561,1.92,46,0.65,189,1558.49,9.05,9.14,199,270,38,73,2.285,11.58633245
2889,266,43,306,28,56,14,97,25,2484,2.44,56,0.59,181,1501.56,7.76,9.14,223,278,42,72,2.285,10.07352436
2952,209,34,237,17,45,11,83,22,2566,2.03,47,0.64,151,1661.39,12.05,9.21,175,220,34,61,2.3025,15.99803357
3141,235,38,264,17,56,12,113,29,2433,2.23,51,0.64,170,1585.45,8.89,9.18,197,247,44,84,2.295,13.06276924
3051,227,38,269,25,46,11,97,25,2623,2.1,48,0.63,170,1747.23,9.99,9.13,189,244,35,72,2.2825,12.48276493
3096,250,41,290,21,56,13,108,28,2693,2.21,52,0.63,184,1779.33,9.33,9.14,209,269,43,80,2.285,12.88673777
3105,246,39,273,24,50,12,103,27,2543,2.11,48,0.61,167,1729.38,10.12,9.18,207,249,38,76,2.295,12.68319703
3069,202,33,240,20,45,11,83,22,2562,1.85,41,0.61,145,1721.27,12.18,9.16,169,220,34,61,2.29,16.73099471
2889,256,41,304,19,44,11,84,22,2502,2.38,57,0.63,192,1451.99,8.82,9.21,215,285,33,62,2.3025,9.347481743
3105,228,36,255,20,42,11,83,22,2666,2.13,48,0.64,164,1554.98,12.06,9.2,192,235,31,61,2.3,13.69856518
3105,252,42,308,22,47,12,84,21,2509,2.22,51,0.62,191,1662.42,10.49,9.14,210,286,35,63,2.285,12.06385572
3132,244,41,288,20,47,11,86,22,2576,1.95,46,0.6,174,1732.26,10.47,9.2,203,268,36,64,2.3,12.43563718
3141,213,35,236,17,43,10,80,20,2506,1.88,43,0.59,139,1603.41,9.94,9.12,178,219,33,60,2.28,12.37338613
2979,213,34,249,17,48,12,97,25,2685,1.94,44,0.65,162,1616.81,12.55,9.2,179,232,36,72,2.3,17.43888401
3132,266,43,316,21,53,12,108,27,2543,2.35,52,0.59,187,1656.56,7.32,9.21,223,295,41,81,2.3025,8.993290938
2925,213,36,234,20,43,10,87,23,2653,1.93,44,0.62,145,1491.8,11.41,9.13,177,214,33,64,2.2825,14.20325309
3069,254,41,304,22,58,14,107,27,2479,2.41,55,0.66,200,1719.02,10.3,9.17,213,282,44,80,2.2925,14.50256534
3033,260,42,298,23,50,12,90,24,2430,2.1,48,0.63,188,1597.3,7.55,9.2,218,275,38,66,2.3,8.952759895
3060,213,34,260,21,42,10,76,20,2604,1.74,40,0.62,161,1629.69,11.48,9.19,179,239,32,56,2.2975,13.95805497
2952,260,42,311,23,52,12,103,28,2616,2.18,52,0.65,201,1610.19,7.85,9.15,218,288,40,75,2.2875,9.680838647
2889,231,37,277,23,45,11,80,20,2414,1.93,45,0.62,172,1639.14,10.23,9.18,194,254,34,60,2.295,12.28823468
3096,222,35,273,21,45,11,99,25,2676,2.09,47,0.6,163,1681.61,10.53,9.19,187,252,34,74,2.2975,13.16137428
3096,242,38,289,23,53,13,106,27,2578,1.95,45,0.64,184,1681.62,11.71,9.19,204,266,40,79,2.2975,15.81359922
3033,221,36,272,16,47,11,85,22,2581,1.97,44,0.61,166,1736,10.67,9.18,185,256,36,63,2.295,13.99211394
3051,231,39,284,19,49,12,92,24,2438,2.11,48,0.64,183,1646.97,11.14,9.16,192,265,37,68,2.29,14.57077394
3123,240,40,280,21,47,12,93,24,2675,1.99,48,0.59,166,1567.93,12.44,9.18,200,259,35,69,2.295,15.02174294
2970,231,37,283,22,49,11,101,27,2587,1.93,45,0.6,169,1485.75,9.6,9.16,194,261,38,74,2.29,12.55650178
2898,207,33,256,21,44,10,86,22,2537,1.77,39,0.61,157,1587.94,9.75,9.15,174,235,34,64,2.2875,12.77910022
2997,222,37,270,16,46,12,81,21,2428,2.02,49,0.59,160,1658.08,12.21,9.2,185,254,34,60,2.3,15.60033234
3132,238,39,277,22,54,12,105,27,2700,1.99,44,0.63,173,1609.62,11.48,9.2,199,255,42,78,2.3,16.06097922
3087,254,41,309,24,55,14,115,28,2420,2.36,56,0.63,194,1706.82,7.3,9.2,213,285,41,87,2.3,9.746869744
3033,258,42,317,23,48,12,96,24,2649,2.08,50,0.65,204,1583.46,9.07,9.19,216,294,36,72,2.2975,10.40500151
3141,233,37,274,18,51,12,94,24,2455,2.14,50,0.63,172,1649,11.82,9.14,196,256,39,70,2.285,15.95309902
3132,249,42,278,20,52,12,93,24,2404,1.98,44,0.64,178,1744.63,7.87,9.18,207,258,40,69,2.295,10.13426037
2970,240,40,287,23,50,12,94,24,2561,1.98,47,0.62,178,1536.41,9.01,9.14,200,264,38,70,2.285,11.57435725
3132,226,37,279,21,49,12,98,25,2675,2.21,53,0.61,171,1787.16,12.29,9.21,189,258,37,73,2.3025,16.43057844
2898,226,38,269,22,47,11,90,23,2526,1.87,41,0.63,169,1630.23,9.3,9.13,188,247,36,67,2.2825,11.92574988
3051,243,40,292,25,49,13,106,27,2604,2.34,53,0.61,177,1530.93,9.64,9.13,203,267,36,79,2.2825,11.98616273
3006,266,43,295,22,57,13,102,26,2448,2.36,53,0.6,176,1664.62,8.44,9.23,223,273,44,76,2.3075,11.1519033
3087,225,36,279,25,49,12,98,25,2583,2.12,48,0.62,173,1776.33,9.03,9.13,189,254,37,73,2.2825,12.1259184
2907,223,38,274,21,47,12,99,26,2685,2.11,49,0.64,176,1663.75,11.99,9.14,185,253,35,73,2.285,15.58208278
2925,246,40,270,21,53,12,95,25,2423,2.2,51,0.65,175,1535.92,10.62,9.14,206,249,41,70,2.285,14.10842743
2979,249,39,285,20,48,11,85,22,2597,2.38,54,0.61,174,1715.45,10.06,9.13,210,265,37,63,2.2825,11.95785272
3033,268,45,320,22,52,12,96,25,2479,2.52,56,0.61,195,1704.92,7.05,9.14,223,298,40,71,2.285,8.434726323
3051,229,37,260,16,45,10,97,25,2519,2.08,48,0.64,167,1535.29,8.79,9.2,192,244,35,72,2.3,10.65072658
2880,261,42,322,22,57,14,103,26,2652,2.28,54,0.66,212,1490.85,10.61,9.18,219,300,43,77,2.295,14.2877243
2880,220,36,268,21,50,12,94,24,2457,2.09,50,0.64,173,1438.08,11.25,9.18,184,247,38,70,2.295,15.76569699
3069,261,44,298,24,46,11,96,24,2619,2.51,56,0.65,193,1642.73,8.01,9.19,217,274,35,72,2.2975,8.704887639
2898,216,35,262,22,46,11,85,23,2478,1.85,44,0.61,159,1466.32,9.07,9.15,181,240,35,62,2.2875,11.91035474
3024,258,41,305,22,53,13,102,26,2547,2.31,53,0.59,180,1519.57,9.03,9.22,217,283,40,76,2.305,11.43818834
2988,237,38,276,20,50,12,90,23,2625,1.95,46,0.61,167,1637.47,11.43,9.2,199,256,38,67,2.3,14.86898139
2916,252,41,302,25,59,14,107,28,2571,2.02,48,0.6,182,1622.07,11.19,9.19,211,277,45,79,2.2975,16.15455081
2988,238,39,294,28,49,11,99,26,2599,2.33,55,0.63,185,1670.03,8.7,9.23,199,266,38,73,2.3075,11.04464357
3051,220,37,273,21,47,12,90,23,2685,1.75,40,0.65,179,1651.08,11,9.13,183,252,35,67,2.2825,14.49042727
2880,231,38,265,21,49,11,97,25,2491,2.03,47,0.59,157,1541.56,12.05,9.19,193,244,38,72,2.2975,15.76102567
2880,247,42,270,21,50,12,104,27,2611,1.98,47,0.66,178,1490.85,9.75,9.18,205,249,38,77,2.295,12.17001171
2889,234,39,276,21,43,11,80,20,2415,1.95,45,0.6,165,1629.43,9.07,9.19,195,255,32,60,2.2975,10.27716229
3069,251,41,301,27,49,11,91,23,2533,2.34,54,0.61,182,1650.61,11.47,9.19,210,274,38,68,2.2975,13.80699303
2898,200,33,220,18,42,11,74,20,2434,1.88,43,0.64,141,1574.72,11.23,9.14,167,202,31,54,2.285,14.54160623
3078,237,39,286,20,55,13,98,25,2616,2.03,47,0.65,185,1601.34,8.97,9.23,198,266,42,73,2.3075,12.83571648
3132,224,37,255,22,44,10,87,23,2651,2.19,51,0.65,166,1760.58,12.44,9.22,187,233,34,64,2.305,15.06740173
3033,254,41,280,17,51,13,94,24,2608,2.19,48,0.6,169,1735.09,10.34,9.23,213,263,38,70,2.3075,12.80177906
3132,248,41,283,16,54,13,115,30,2694,2.13,49,0.64,180,1609.6,11.59,9.2,207,267,41,85,2.3,15.56104807
3060,267,44,322,26,53,12,95,24,2628,2.56,61,0.65,208,1591.72,10.77,9.13,223,296,41,71,2.2825,13.18237436
2907,238,39,266,22,43,10,85,23,2657,2.15,50,0.63,167,1551.27,9.08,9.13,199,244,33,62,2.2825,10.11557737
3105,229,37,269,21,48,11,102,27,2589,1.9,43,0.63,170,1599.57,9.88,9.22,192,248,37,75,2.305,12.76956282
3141,231,38,286,21,52,11,96,25,2416,1.83,42,0.63,180,1604.15,10.44,9.21,193,265,41,71,2.3025,14.49122807
2898,265,43,303,22,55,13,113,29,2514,2.48,56,0.62,188,1536.26,7.24,9.19,222,281,42,84,2.2975,9.265496813
3069,202,33,238,20,42,9,76,19,2529,1.73,41,0.65,155,1713.11,11.12,9.16,169,218,33,57,2.29,14.25660239
3060,246,42,276,23,50,11,99,26,2424,2.26,50,0.64,178,1621.72,8.26,9.19,204,253,39,73,2.2975,10.3520956
2934,228,38,251,22,42,11,77,20,2550,1.88,41,0.65,163,1496.16,11.53,9.22,190,229,31,57,2.305,13.09655527
3132,231,37,258,14,43,11,90,22,2447,1.87,44,0.65,167,1666.88,9.35,9.2,194,244,32,68,2.3,10.73201858
2988,215,35,253,19,47,11,99,26,2430,1.76,40,0.59,150,1687.21,9.72,9.14,180,234,36,73,2.285,13.10204215
3123,217,36,249,18,42,10,79,21,2586,2.01,46,0.64,161,1586.26,11.16,9.17,181,231,32,58,2.2925,13.31886081
3015,259,42,295,27,55,13,105,27,2417,2.35,55,0.63,185,1724.55,7.99,9.23,217,268,42,78,2.3075,10.46220039
3123,243,39,287,18,53,13,99,26,2591,2.16,50,0.65,187,1568.47,12.04,9.22,204,269,40,73,2.305,16.19233246
3105,212,34,260,18,45,10,82,22,2495,1.93,43,0.63,164,1578.86,10.02,9.16,178,242,35,60,2.29,13.11468016
2952,213,34,252,20,51,12,100,26,2665,2.01,46,0.59,149,1478.7,13.5,9.2,179,232,39,74,2.3,19.93139382
2916,239,38,264,24,43,10,84,22,2687,1.98,47,0.59,157,1586.12,11.36,9.18,201,240,33,62,2.295,12.60265987
2898,203,35,240,17,46,10,95,24,2500,1.89,43,0.62,150,1500.27,9.51,9.18,168,223,36,71,2.295,13.28787824
2970,237,38,265,21,54,12,107,27,2658,2.31,51,0.66,174,1699.26,10.68,9.19,199,244,42,80,2.2975,15.00479256
3069,244,41,275,23,52,13,93,24,2442,2.03,48,0.63,172,1677.1,9.81,9.13,203,252,39,69,2.2825,12.89127443
3096,256,42,300,26,51,12,96,24,2645,2.17,51,0.64,194,1554.65,8.4,9.22,214,274,39,72,2.305,10.31864868
2988,268,43,320,23,52,12,110,28,2657,2.25,54,0.61,194,1697.18,11.22,9.13,225,297,40,82,2.2825,13.42377721
3042,218,36,261,24,46,12,85,22,2490,1.79,40,0.64,168,1621.68,11.69,9.23,182,237,34,63,2.3075,15.20999875
3015,262,43,319,24,50,12,95,24,2642,2.15,50,0.59,189,1571.97,7.66,9.16,219,295,38,71,2.29,9.013860071
3123,243,40,275,20,47,12,96,25,2604,2,45,0.64,175,1635.37,10.41,9.17,203,255,35,71,2.2925,12.41525497
2943,212,35,233,20,44,11,90,23,2579,2.03,48,0.61,141,1468.2,11.25,9.24,177,213,33,67,2.31,14.39735347
2925,269,42,333,22,51,13,101,26,2632,2.28,53,0.6,200,1664.31,9.38,9.24,227,311,38,75,2.31,10.96564201
2907,226,37,256,20,46,11,92,24,2667,1.96,45,0.64,165,1548.59,12.51,9.19,189,236,35,68,2.2975,15.70073673
3069,229,35,251,17,42,10,78,20,2615,2.06,49,0.59,149,1743.13,12.5,9.17,194,234,32,58,2.2925,14.13634548
3060,236,39,273,19,45,11,96,24,2593,2.15,51,0.66,180,1601.73,10.74,9.21,197,254,34,72,2.3025,12.62752164
2988,252,40,312,25,49,12,101,26,2590,2.18,49,0.66,205,1661.54,11.63,9.15,212,287,37,75,2.2875,13.94403882
3060,267,44,316,25,60,15,109,28,2631,2.41,55,0.6,189,1577.87,9.24,9.21,223,291,45,81,2.3025,12.80339928
3123,258,41,300,20,54,13,95,24,2689,2.25,52,0.59,179,1557.99,9.13,9.19,217,280,41,71,2.2975,11.78306194
3141,215,34,260,18,41,10,73,19,2497,1.74,40,0.61,159,1805.67,12.17,9.14,181,242,31,54,2.285,14.31031865
3042,207,35,240,21,47,12,90,23,2634,1.75,42,0.63,151,1552.41,12.19,9.17,172,219,35,67,2.2925,17.06650323
3078,210,36,231,17,48,12,86,23,2576,1.82,41,0.61,140,1770.26,12.08,9.18,174,214,36,63,2.295,17.02559139
3006,226,37,268,20,50,12,90,23,2496,1.82,41,0.63,168,1547.33,9.08,9.23,189,248,38,67,2.3075,12.38684613
2907,249,40,308,20,48,12,99,26,2616,2.34,54,0.62,190,1444.26,9.78,9.18,209,288,36,73,2.295,11.62502979
3033,260,42,296,25,47,11,88,22,2455,2.35,55,0.62,182,1692.17,8.66,9.2,218,271,36,66,2.3,9.652853861
3069,228,38,257,17,45,11,91,24,2485,2.2,51,0.6,154,1580.28,11.78,9.13,190,240,34,67,2.2825,14.33627379
3069,206,34,238,21,45,11,83,22,2594,1.97,44,0.64,152,1668.37,12.59,9.23,172,217,34,61,2.3075,16.95837962
3024,258,41,304,25,48,12,97,25,2463,2.33,55,0.65,197,1743.17,9.81,9.16,217,279,36,72,2.29,11.25392115
3033,201,33,228,19,38,9,77,19,2578,1.8,43,0.64,147,1741.81,11.35,9.19,168,209,29,58,2.2975,13.23112371
3114,219,36,255,21,43,10,82,22,2448,1.77,43,0.62,159,1665.27,10.67,9.15,183,234,33,60,2.2875,12.91820254
3096,244,40,290,25,54,12,115,31,2661,2.06,48,0.6,173,1606.96,8.97,9.2,204,265,42,84,2.3,12.24079728
3141,220,35,261,18,46,11,100,26,2511,2.01,49,0.64,167,1565.12,11.8,9.2,185,243,35,74,2.3,15.21354724
3078,265,43,328,21,58,14,104,27,2594,2.44,54,0.64,210,1698.33,8.04,9.13,222,307,44,77,2.2825,10.85054363
2961,224,36,270,19,43,10,93,24,2478,2.1,48,0.65,176,1685,10.71,9.15,188,251,33,69,2.2875,12.67719695
2970,251,43,304,21,51,13,98,26,2660,2.1,49,0.66,199,1489.7,9.27,9.19,208,283,38,72,2.2975,11.61420582
2997,248,41,305,28,46,12,82,21,2556,2.37,57,0.6,182,1552.51,10.24,9.17,207,277,34,61,2.2925,11.71168645
2988,229,39,258,21,47,11,90,23,2512,2.02,46,0.62,160,1670,11.3,9.23,190,237,36,67,2.3075,14.30059635
2997,233,37,277,23,48,11,91,24,2618,2.06,49,0.64,177,1626.76,9.14,9.2,196,254,37,67,2.3,11.61033742
3051,232,38,268,21,51,13,94,25,2513,2.07,50,0.65,173,1694.88,8.57,9.16,194,247,38,69,2.29,11.61652797
2997,248,40,279,19,52,12,104,26,2565,2.01,47,0.62,172,1529.04,8.61,9.22,208,260,40,78,2.305,11.13187045
2961,216,35,244,19,50,12,91,24,2574,1.96,46,0.64,156,1588.16,10.69,9.13,181,225,38,67,2.2825,15.25833999
3015,256,41,292,19,56,13,108,27,2530,2.41,55,0.59,172,1565.97,9.46,9.19,215,273,43,81,2.2975,12.76005444
3060,213,35,256,24,41,10,77,21,2558,1.89,42,0.63,161,1567.85,12.28,9.18,178,232,31,56,2.295,14.57524787
3123,254,40,299,21,52,13,104,26,2591,2.42,57,0.65,195,1760.09,9.64,9.15,214,278,39,78,2.2875,12.16914288
2925,239,38,280,17,43,11,80,21,2500,2.29,52,0.66,184,1637.05,9.06,9.18,201,263,32,59,2.295,10.051065
2979,203,33,251,21,46,11,87,22,2527,1.94,43,0.63,159,1521.68,11.81,9.16,170,230,35,65,2.29,16.50156068
2880,264,44,315,24,62,14,115,29,2471,2.32,55,0.6,189,1497.86,7.79,9.23,220,291,48,86,2.3075,11.28076493
2943,219,35,239,18,42,10,80,21,2541,1.77,40,0.66,156,1649.45,10.56,9.16,184,221,32,59,2.29,12.48769903
3069,250,40,281,24,56,14,104,28,2463,2.45,56,0.61,170,1556.69,10.58,9.23,210,257,42,76,2.3075,14.61325677
3042,258,41,299,25,47,11,101,26,2544,2.18,51,0.6,179,1566.28,8.53,9.18,217,274,36,75,2.295,9.581654624
2961,225,35,270,24,39,10,78,20,2528,2.1,51,0.65,174,1644.2,12.61,9.16,190,246,29,58,2.29,13.47753613
3051,208,35,244,22,46,11,94,24,2636,1.8,40,0.63,155,1765.53,11.09,9.12,173,222,35,70,2.28,15.12304945
2943,264,44,290,21,59,15,115,30,2700,2.27,51,0.62,179,1602.51,11.2,9.21,220,269,44,85,2.3025,15.43403343
2880,249,39,294,20,49,11,88,22,2503,2.24,54,0.59,174,1649,10.39,9.18,210,274,38,66,2.295,12.60740225
2907,225,37,277,24,47,11,90,24,2616,1.95,43,0.61,170,1552.12,11.61,9.21,188,253,36,66,2.3025,14.95412095
3015,238,39,281,21,52,12,101,26,2690,1.98,44,0.65,182,1670.87,10.87,9.14,199,260,40,75,2.285,14.64432167
3051,225,38,253,23,51,11,109,28,2651,2.08,48,0.6,151,1548.87,9.42,9.12,187,230,40,81,2.28,13.16594056
2889,251,39,284,19,53,13,97,25,2595,2.19,51,0.6,172,1457.81,9.48,9.18,212,265,40,72,2.295,12.3430877
3051,217,34,249,22,47,11,92,25,2613,1.78,41,0.65,161,1660.93,10.76,9.17,183,227,36,67,2.2925,14.37023018
2943,215,36,247,20,43,11,92,23,2558,1.83,42,0.64,158,1558.45,12.6,9.2,179,227,32,69,2.3,15.53867095
3042,233,37,264,25,47,12,84,22,2463,1.89,46,0.62,162,1755.83,10.28,9.15,196,239,35,62,2.2875,12.78640278
3123,204,34,240,20,49,12,90,23,2554,1.73,38,0.64,153,1735.27,10.54,9.2,170,220,37,67,2.3,15.61060924
3078,232,38,254,21,46,11,94,25,2561,2.13,49,0.61,156,1603.39,11.66,9.21,194,233,35,69,2.3025,14.25547611
2916,240,39,295,25,49,11,91,24,2533,2.34,52,0.65,193,1513.83,10.14,9.15,201,270,38,67,2.2875,12.76544981
3042,207,34,239,19,51,13,96,25,2672,1.81,42,0.65,156,1664.26,10.08,9.12,173,220,38,71,2.28,15.31347282
3114,207,33,233,20,41,9,80,21,2642,1.91,44,0.62,145,1718.39,14.32,9.13,174,213,32,59,2.2825,17.48919655
2979,211,35,236,19,48,11,98,26,2481,1.76,41,0.6,142,1585.7,11.12,9.2,176,217,37,72,2.3,15.5982867
2988,242,38,295,24,49,11,104,26,2433,2.11,48,0.63,185,1651.6,9.18,9.16,204,271,38,78,2.29,11.46137506
3060,248,39,287,24,47,12,88,23,2484,2.02,47,0.6,172,1541.6,9.64,9.15,209,263,35,65,2.2875,11.26513862
3069,210,34,239,22,46,11,81,21,2439,1.78,42,0.64,152,1769.39,13.02,9.16,176,217,35,60,2.29,17.58582918
3069,259,43,287,19,60,15,122,30,2592,2.4,57,0.6,171,1630.66,8.96,9.17,216,268,45,92,2.2925,12.79890529
2979,256,41,281,23,55,13,111,27,2525,2.29,51,0.61,170,1486.4,8.73,9.14,215,258,42,84,2.285,11.56512409
2925,245,41,304,20,45,11,94,23,2658,2.05,49,0.63,192,1595.89,9.08,9.24,204,284,34,71,2.31,10.28361022
3087,253,41,298,19,45,12,89,23,2683,2.03,45,0.62,184,1650.55,8.32,9.16,212,279,33,66,2.29,9.124911229
2979,250,41,308,20,55,13,112,29,2558,2.29,55,0.65,200,1657.01,10.71,9.23,209,288,42,83,2.3075,14.52865734
2997,220,36,249,22,43,10,78,20,2515,1.83,42,0.64,158,1538.81,13.14,9.21,184,227,33,58,2.3025,15.83632731
2898,262,43,315,23,61,14,122,31,2603,2.13,49,0.6,189,1658.51,9.76,9.14,219,292,47,91,2.285,14.01172776
3069,247,41,277,20,54,13,99,26,2610,2.4,55,0.62,173,1697.03,8.09,9.16,206,257,41,73,2.29,10.90582834
3105,242,37,274,26,51,13,92,25,2683,2.28,51,0.61,168,1777.3,10.02,9.22,205,248,38,67,2.305,13.02074582
3024,220,36,258,21,43,10,95,24,2697,1.81,43,0.64,165,1513.52,10.48,9.21,184,237,33,71,2.3025,12.63049545
3087,231,37,274,20,48,12,89,22,2651,2.01,47,0.6,163,1531.52,12.94,9.19,194,254,36,67,2.2975,16.57970745
3114,221,37,243,17,43,10,89,23,2696,1.88,42,0.6,145,1602.17,11.54,9.19,184,226,33,66,2.2975,13.84507523
2961,244,40,282,21,53,12,99,26,2598,2.24,53,0.63,177,1508.44,9.23,9.19,204,261,41,73,2.2975,12.3623511
2889,229,36,276,26,42,9,81,21,2562,2.01,49,0.61,169,1656.45,11.56,9.17,193,250,33,60,2.2925,13.0732923
3141,216,35,257,15,44,12,90,24,2591,2.09,45,0.6,155,1759.71,11.42,9.21,181,242,32,66,2.3025,14.34426694
2889,262,42,321,20,53,13,106,28,2674,2.5,59,0.65,209,1516.3,7.77,9.19,220,301,40,78,2.2975,9.691900042
3087,259,42,306,18,52,11,101,26,2402,2.1,51,0.62,190,1595.99,8.76,9.19,217,288,41,75,2.2975,10.84478671
2961,231,38,272,17,49,11,100,26,2491,1.98,46,0.64,174,1659.69,10.25,9.16,193,255,38,74,2.29,13.40668158
